CACAGAACGTCTATTCAGACAGG	Secondary structure or energy
AGCTGGGCGGAGGCCGGGCCAGG	AT%
ATGCAATATTCTCTACTTTGGGG	Secondary structure or energy
GCGCAGGACCCAGGGCTCTGGGG	AT%
CCCATACAGTCTCCTAGGGTAGG	Multiple matches in exons
CCCGGCTGTGGCACTGCCTCAGG	Multiple matches in exons
CCTGAGGAAAGGGGCTGCAGAGG	Multiple matches in exons
CAGCTCAGGGGTGGGGGCTTGGG	AT%
GTCTTCCACCATGGCCGTGTGGG	AT%
CCTCCTGCCCCAAGAGAGAGGGG	Multiple matches in exons
GGGAGTTCTGGCCAGAGGCAGGG	AT%
GTCTGAGAGGTGCGCGCTCCGGG	AT%
CCCTTTTAAAAGGTGTATGCAGG	Multiple matches in exons
GGGGGAGGGACTTGAGGGTGAGG	AT%
CTTCCCTAGATCCCCTTTTTGGG	TTTT
AGGAACCCAGCCCTTTCCCCAGG	AT%
GCCAGTTCTAGTCTCAGCAGAGG	Secondary structure or energy
CTGTTGTGTGCCCCACTGCAGGG	AT%
CCCGCTTGGGCCCAATGCCACGG	Multiple matches in exons
GTGACAGCCAGAGGGAGGGGAGG	AT%
CCCAGCTTCAGGTGCCGGCTGGG	Multiple matches in exons
GGACAGTGGAGGGGAAGGACAGG	AT%
ATGGTCACGGGCCCCGGCCCGGG	AT%
AGGTCAGTCAGGGCATCCTTGGG	Secondary structure or energy
AGCTGAGCGGGCGGCGGTTGCGG	AT%
GACGGCAGCTTCATTTATGGAGG	Secondary structure or energy
CCCCTATGCCCCAGGGTGAGTGG	Multiple matches in exons
CCTTCCTAGAAAGGGTGTACCGG	Multiple matches in exons
CCCCAGGGTGAGTGGGGGCAGGG	Multiple matches in exons
CACCGCCCCTAAGCCCTTCCTGG	AT%
GATCTGCTCCCAGCGGAAGATGG	AT%
CTGAAAACCCTGCGCGCGAACGG	AT%
CCTGAAGTTGCCAGGAAGTCTGG	Multiple matches in exons
GAGTCCTCTTCCTCCTGCTCTGG	AT%
ACAGTATGGCTGCAGCCTTGGGG	Secondary structure or energy
GCCTTTCCTCACCGCTCTGGTGG	AT%
AGTACTGCTCAGTACAGTTCAGG	Secondary structure or energy
ACACAGGCAGGCCGGGGCGGGGG	AT%
GGTGGCGGTGGTGGTGGGCCTGG	AT%
GAGCCGCGGAGCCGGGGAGCGGG	AT%
AGCCCACAGCAAGTCCTGCGAGG	AT%
ACCTGGTACCCAAGCCCCCCAGG	AT%
CCCCCGGGCCAGGCTGTAGCGGG	Multiple matches in exons
CCCACCCCTCCACCCAGGCTGGG	Multiple matches in exons
GCCGGCGATGCCGCGCCCCCGGG	AT%
CCAGGCCAGTGGGCAGAGGTGGG	Multiple matches in exons
AGGATTTTAATAAGTCGCCTTGG	TTTT
GCATGTAAGTGAAGAAGATGCGG	Secondary structure or energy
CCTCCAGGATCAAGGGTCCAAGG	Multiple matches in exons
CTGAGGCACTGCCTCGGCAGGGG	AT%
CCCTTGATCCTGGAGGACCCTGG	Multiple matches in exons
GTCAATCTTGCCCAGTGACTCGG	Secondary structure or energy
CTTCAGCCGCCGCCACCCGGGGG	AT%
AGAGCAGCAGACGATGGGGCAGG	AT%
CCTGCGGCGGGCCGGAGGTAAGG	Multiple matches in exons
AGGCCACCATCACCTGACCTAGG	AT%
GCAGGCAACGTGCAGAAGGCAGG	AT%
GAATCTGCTGGGCTTGGCTCAGG	AT%
GGGGGGCTTGGGTACCAGGTTGG	AT%
CGAGGCTGACTTGGTAACTGAGG	Secondary structure or energy
CACCAAAGCTGGACCCCGAAAGG	AT%
CTGAGGAAAGGGGCTGCAGAGGG	AT%
CTTCATGGGTCCTGGCCACTGGG	AT%
GTGGATCAGGGGAACCTCCTTGG	AT%
AGGGGTACCAGAACTCTACTGGG	Secondary structure or energy
AAGTCTCTGAATTGGTTTTGAGG	TTTT
GGCTTCTACCAGGCCTCCTGAGG	AT%
GCCTTCTACCCCCAGGACTCTGG	AT%
GGCAGGGAACGGGCACGGGGAGG	AT%
CCTTATCCATCATAGCCCACTGG	Multiple matches in exons
CTACGGCCTCCGGGCGCCCGCGG	AT%
GGGACAAGAGCAGCTCCCCTCGG	AT%
CCCCACTCACCCTGGGGCATAGG	Multiple matches in exons
GCAGGTGGAGGGGTGTGCTGGGG	AT%
CTCAGGACGGATGGGTGGTACGG	AT%
GAGTGGGACCTAAGGACCAGAGG	AT%
GGGACGCCGCTGCCACCACCCGG	AT%
GAGGAACACTTTTAGACGGCGGG	TTTT
CGATGCTGAGCGCCTCCCTGTGG	AT%
GCTGCTGATGCAGCAGCCACTGG	AT%
CCCACTCACCCTGGGGCATAGGG	Multiple matches in exons
GGCAGCGGCGTCCCGGGCCGGGG	AT%
CCTCTTCTGGGCCCCAAAAAGGG	Multiple matches in exons
GGGCTGGCCCTTCGTGTCTAGGG	AT%
GGGGAGAAGTCTTGGGGACAAGG	AT%
GGGAGGGCTTTTGTTCTGAAGGG	TTTT
GGAAGTTCCAAAGATCCAAAGGG	Secondary structure or energy
CTCCCTGCCTGACCCTAGAAGGG	AT%
GCGGCCAGGTGGGTAGAGTGGGG	AT%
CAGGAGGAAGGAGAGGATGGCGG	AT%
GGCGCGCGAGGACGCGGCTACGG	AT%
CACCCTGATAGCTGTATGTATGG	Secondary structure or energy
ACATGTGCTGTGGAGAACAGAGG	Secondary structure or energy
GGCCCGGGCCGCTCCGGCCTCGG	AT%
CCGGAGGGGGACCCGGGCCGCGG	Multiple matches in exons
AAAGCAGTTGAAGGAGGCTTGGG	Secondary structure or energy
AGATTGAGCACCAGTGAGTGTGG	Secondary structure or energy
GTGGGACCTAAGGACCAGAGGGG	AT%
AGCCCCCTCTGTGCTGTGTGAGG	AT%
GGACCACGGCCGAGGCTACCTGG	AT%
CGATGAGGCGGCTACCCCCTGGG	AT%
AAGCTCTCCCAGCCATGCGCTGG	AT%
GGCGGTCCCTAGAGGCTCTGTGG	AT%
CCTGAGTTCGCTGCTAGCGCAGG	Multiple matches in exons
AGCGGCGGCAGAGAAGCGCGCGG	AT%
CTACAAGAATTCCTTGGAGACGG	Secondary structure or energy
AGTCCCCACAGCTGGTGATGAGG	AT%
GAACTTTGAAGTTGAAAATCTGG	Secondary structure or energy
GACTCCCTGTTACTTTTGCTGGG	TTTT
GCATGGCTGGCAGCTCTGGGAGG	AT%
AGTGTCCCGATCAGAGCCTCTGG	AT%
GCGCGCGAACGGCGGTCTCCGGG	AT%
GAGGGGATGGGGCTCTGGCAGGG	AT%
CCCTGACAAAGAAGGCAAGGAGG	Multiple matches in exons
AATGACATCAAGAGCTACTTTGG	Secondary structure or energy
CTAGGTTTTTCCAGGGGACTGGG	TTTT
CTCGCGAACTAGGGGAGCGTCGG	AT%
CGGGGCCAGCCCCACCAAGCAGG	AT%
GGTCTCTGTCCTTACCTGTTAGG	Secondary structure or energy
GGTGGGGGAGGTGGCGGTGGTGG	AT%
GGAGGAGGCTCCGCGCGGCTCGG	AT%
CTGACGGGCCAGGTCAGCCTTGG	AT%
AACTACACTTAGGAAGTTAAGGG	Secondary structure or energy
CGAGTCTGGCAGTGTGCTGCAGG	AT%
AGGGAAAGTTGGTGGCTCAGTGG	Secondary structure or energy
CCTGCAGATGAAGTGAGTGCTGG	Multiple matches in exons
CTTCACTCCATGCCACATCTGGG	Secondary structure or energy
GCCATACTGTGTTACAGGCTTGG	Secondary structure or energy
CTGGCAGGTGGGCTGGAGGTGGG	AT%
CCTGTCCCACATCATCGTCATGG	Multiple matches in exons
GCCTCGGGGGCCCCCCGCCCCGG	AT%
AGAGTTGCCCTGACTCCTTCAGG	Secondary structure or energy
CCTATGCCCCAGGGTGAGTGGGG	Multiple matches in exons
CAGCCACTGGGGACAGCAGCCGG	AT%
GACTGTACCGGGAGCCCAGCCGG	AT%
CGAGGAGATCGTGAGGCGGCTGG	AT%
CCCCAGGAAGGGCTTAGGGGCGG	Multiple matches in exons
AGCCGCCAGGGCAGCACCCAGGG	AT%
CTTGTAGTTAGCGTCATACAGGG	Secondary structure or energy
GTGCCTCTGTGTCCCTCCACAGG	AT%
AGACCCTGACCACTGGCACAGGG	AT%
ATCGGAGGAGGAGCCCTGTGAGG	AT%
CAGACAGGGAACCCTGCCCAAGG	AT%
GATGATAATAAATATTTTAAGGG	TTTT
GTGTGAGGCAGGGGCCCCACGGG	AT%
AATAGGGTTTTGTAATCTTCTGG	TTTT
CCCTGACCCCACCTCCCTTCGGG	Multiple matches in exons
GAAAGCCTATATATCTATACTGG	Secondary structure or energy
GGCTTCACTGGTACTCCCCTAGG	AT%
CTGGCCCCTCAGTCCTTAACTGG	AT%
CCGGTTCTCACCTGGAACCAGGG	Multiple matches in exons
CTGTCAGGGTAGGTCTGGGGGGG	AT%
GCACCTGCCCTATGTGGTCATGG	AT%
AAAGCACAGATCTTTGCCAGTGG	Too close to reverse primer
AGGTGCGCGCTCCGGGCCGCGGG	AT%
GATCCTCTTCAGCTGCTCGGTGG	AT%
AGGCTGGGCCAAGCAGGACATGG	AT%
CCGCAACGACGTCATCGGCAAGG	Multiple matches in exons
AGGCTCTCCATGGTGGCCAGTGG	AT%
ACCGTCGGTGTTGCGAGCCGCGG	AT%
ACGGTGTCTGCCACCCGCGGGGG	AT%
CGACTTCAGCCGCCGCCACCCGG	AT%
CAGGGACTGGGTGGTAAGTCAGG	AT%
CTCTGCGATGCCCATGGTCACGG	AT%
AGGCCTCAGAGCCTGAGTCTGGG	AT%
AGCCTCGGCCGTGGTCCACCAGG	AT%
CTGGGGTCAATCCCCAACACTGG	AT%
AGAGGTCAAGGCCACAGGGAAGG	AT%
GGGGGCGCAGGAGGAAGGAGAGG	AT%
GAGAGCGAGATGCCAGAGGAGGG	AT%
GCTATACAAAGCCCAGAAGGTGG	Secondary structure or energy
GGCCTCTAGCTAGAGAGGAATGG	Secondary structure or energy
ATTCATGAAAGTCCAACACTTGG	Secondary structure or energy
GTCTGCCCGCCTGGTCCTGCTGG	AT%
GGACGGGTTCTCCTCGGGAATGG	AT%
GGGAGGTCTTGGCGATCTCAGGG	AT%
AGCAGGTGTAAAGTTGGCAGCGG	Secondary structure or energy
GGCAGACACCGTTTTCCTAGTGG	TTTT
GAGGCACCCTGTAAGGGGAGAGG	AT%
CGGTCCAGGCTGGGCTCCTCTGG	AT%
GTCTGAGAGGCTCTCCATGGTGG	AT%
AGACCTCGACCGCAACCGCCTGG	AT%
CCCAACTGCTACCATAGATGTGG	Multiple matches in exons
GACTACTGCGAGAGCATCCGTGG	AT%
ACCAGAGGGGCCCCGAAGGGAGG	AT%
CCGCGGCGGGCCGAGCCCTGCGG	Multiple matches in exons
GGGCACCAGACCCGGCCCCATGG	AT%
GAAGGATGCCCAGGTAGCCTCGG	AT%
GTTGTCCACAAGTTTGTCATTGG	Secondary structure or energy
GCCCAAGTACGTCAAGACACCGG	Secondary structure or energy
AAAGAGGTCTCAGAAGCTTTAGG	Secondary structure or energy
CCCAAGTAAAGTAGCGCGTTTGG	Multiple matches in exons
AGCTATCAGGGTGGAGAACTGGG	Secondary structure or energy
GCGGTGGAGCGATTGACAGGCGG	AT%
GCCTAGCTCCTTTCTGGGTCTGG	AT%
GGACACAGAGGCACCTGGTTGGG	AT%
GTTTAAAAGGTTAGGGAACATGG	Secondary structure or energy
GTGGTCTCTGCCAGCTGGCTCGG	AT%
GGCTGCTAAGGGGAACAGCATGG	AT%
AGAAGATAAAGCCGGGAGCGAGG	Secondary structure or energy
CAAGCCCAACATCTTCCACAAGG	Off-target score
GAGCCTGGCCGGACTGTACCGGG	AT%
GGCCAACCACCTCTTCTTCCTGG	AT%
GGTGGGCTGGAGGTGGGGGCGGG	AT%
GCTGCACCGAGCCGCGGAGCCGG	AT%
CTACCTGGGGAGGGTGCACCTGG	AT%
GCGGTGTCGGGGAGCCCGGAGGG	AT%
GTTTTCTTTAAGGCAGTGCCTGG	TTTT
CAATCCCCAACACTGGAGAGGGG	Secondary structure or energy
CAGATGGGAGCAGCTCAGGATGG	AT%
AGGGGACTGGGATAGCAGAGAGG	AT%
CCTCTGCTTGCGTGGTGGGTGGG	Multiple matches in exons
CACAGACTCCCTGCCAAGCAGGG	AT%
CATCGGCAAGTTCCAAGCTGAGG	Secondary structure or energy
CCAGAGCCCCATCCCCTCCATGG	Multiple matches in exons
GCCTGGTGGGTACCTGGAAGAGG	AT%
CGGGCCGGGGCCCGTGACCATGG	AT%
GACACAGGGGTGGAGGAACTAGG	AT%
GACTGGGCAAGCTCTCAGGTAGG	AT%
CCGTCATGCCAAACCTACCTAGG	Multiple matches in exons
CCTACCAGGCGACAAGTGGCTGG	Multiple matches in exons
CATGGTGTTGGAAATGTCGGTGG	Secondary structure or energy
ACACCAAAGAGACAGGGTTTTGG	TTTT
GGCGGGCGGCCCCCGCTCCCCGG	AT%
GGTCTCCGGGCGCGCGCTCGAGG	AT%
CAATGTTGATAGACTGGTTCAGG	Secondary structure or energy
GGAGAACAGAACGAGGTCTTAGG	Secondary structure or energy
CCCGAAGCAAGATTTCCTGTTGG	Multiple matches in exons
AAAGGAAGGCTTTGTTGGTAGGG	Secondary structure or energy
GGAGGAGATGTCAGGTTGGATGG	Secondary structure or energy
CCAGCAACAGCCGTTGCCCACGG	Multiple matches in exons
GGGGCCGCCCGCCAGCCCTCCGG	AT%
CGCGGCCCGCGCGACAGTCCCGG	AT%
AGGCATTGAAGCCACCGCACCGG	AT%
AGGGCACGATGTCGAGGTCACGG	AT%
CGTAAGAGCGTGCGCCTGCCCGG	AT%
GCTGGGCCACATCCTGGCTATGG	AT%
GACATGGACTGCCTCACTTTTGG	TTTT
GCTGCCCGTGGGCCTCAGGCTGG	AT%
GGCCAGAGGTTCCAGGCTCTTGG	AT%
CCAGATACGGTCTTCCACCATGG	Multiple matches in exons
CGGAGGGGGACCCGGGCCGCGGG	AT%
CCATTGCCAACGGGAGGGGCCGG	Multiple matches in exons
CGGCCTGCTCACCTCTGGTCAGG	AT%
CTTTTTCTCATTTTTAGCTCAGG	TTTT
AGGTTGTGACGTGGCATAGTGGG	Secondary structure or energy
GCATGGTGGGGAAGAGGCTTTGG	AT%
GCAAGGCTGGGGGTCCGACTGGG	AT%
GGCCAAGGAGCACGTGCAGGAGG	AT%
CTCTGGCCTTTCTGGATGCTGGG	Secondary structure or energy
CCTCTCCAGGTCCTCCATCCAGG	Multiple matches in exons
GCCTCAGGCCTGCCTGTGCCGGG	AT%
GCAAGCTCTGAGGTCGGCAGAGG	AT%
GGCCCTCGTCTTGTTGGGGTTGG	AT%
GTTGACGAGGTCCGAGACAGAGG	AT%
GTCACTTTTGTGACCTGCTCAGG	TTTT
ACCCTCCCAACTCCCTGCAGAGG	AT%
ACAAAGGCTGTGACGAGGGTAGG	Secondary structure or energy
GCCACTGGGCCACAGGCTGCCGG	AT%
CTCACCAGGTGGTGTGTAGCAGG	AT%
AGGAGCACGTGCAGGAGGTAGGG	AT%
GGAGACCGCCGTTCGCGCGCAGG	AT%
GTCATCCTGCTTGGTGGGGCTGG	AT%
ACCCAGTCACTGGACCCCCGCGG	AT%
GGCCATCTGGCCAGGGCCTACGG	AT%
GCGCAGCGGCGAGCAGCAGCTGG	AT%
CAGGATTGTCCAGGGTGTCCAGG	AT%
CAGCCCAGAGAGGCTGGGAGTGG	AT%
CCTTACCTCCGGCCCGCCGCAGG	Multiple matches in exons
AGTTGTGCCGCGGCATGGTGGGG	AT%
ACCTCATGGGGGAGGTTGTGAGG	AT%
AGGGTGTACCGGGAGGACGTGGG	AT%
GTGTTTGGTTCCACGGCCCTGGG	AT%
GTCAGTCACCTACCTGGGGAGGG	AT%
AGGCTGGGGGGAGGGGGAGGGGG	AT%
AGGCCTCATCACCAGCTGTGGGG	AT%
CCAGAGCTGCCTAGGCATGGTGG	Multiple matches in exons
CCCTTATGCTGCCATGGGGCCGG	Multiple matches in exons
GCAGACACCGTTTTCCTAGTGGG	TTTT
GGATAGCAGAGAGGCCCACAGGG	AT%
CCCCATGCTGCCAGTCTACCCGG	Multiple matches in exons
GGCCAGCTCACCAATCAGCAGGG	AT%
GGCAGTGTCTGTGAAGCCACAGG	AT%
CGCTTCTCTGCCGCCGCTGCAGG	AT%
GGTCACCTCCACCTGATCCTCGG	AT%
CCCAGAGGCCAAATGGTCTCAGG	Multiple matches in exons
GCCGCTGTACACAAGTCCTCCGG	AT%
GTCCACCAGGTTCAGGGAGCAGG	AT%
GACACATGGGCAGTTACCTTGGG	Secondary structure or energy
AAAGTGACAGTGACGTGCTGTGG	Secondary structure or energy
CAGCAGGCACCAGATCTGGGGGG	AT%
CGGCCCGGGCCCCGTCGGGGCGG	AT%
CTACGGCATCTTGGGAGCCCTGG	AT%
GCCCGGGCCGCTCCGGCCTCGGG	AT%
CCCGACCCGGTGCCGACCCCTGG	Multiple matches in exons
CCCAGCCTGGGTGGAGGGGTGGG	Multiple matches in exons
CTGGGGTCAAGGACAGTGGAGGG	AT%
ATCAGGTACCCCAACTTTGCTGG	Secondary structure or energy
GACACCCAGGTAGGGGTAGGTGG	AT%
GGTGGGCCTGGCAGGTGGGCTGG	AT%
GGAAGATAGCTGGCAGGACGAGG	AT%
GGAGCACAGCTTGCTGCTGAGGG	AT%
ACTCCCTGTTACTTTTGCTGGGG	TTTT
CTAGGCAGCCCAGAGAGGCTGGG	AT%
CGAGGTCCGAGACAGAGGAACGG	AT%
GGAGAGGTCCCATCGCGTCTGGG	AT%
CTGTGGGAAGGACGGCCTTATGG	AT%
GCAGGTCCAGCCAGAGCTTCGGG	AT%
CCCACTAGTGACTACACTGAGGG	Multiple matches in exons
GCTGGCCCATGTACCTGATGAGG	AT%
CCGGGGAACACTGTCCCCCAAGG	Multiple matches in exons
CTCCATGACCCAGAGCACCCAGG	AT%
GCCTCTGGCCAGAACTCCCCCGG	AT%
CCGCGTAGTGGCTGATGACCCGG	Multiple matches in exons
GCGCTCAGCCATGCGCTCGACGG	AT%
CGCTTCCTCTGCTTGCGTGGTGG	AT%
GCGGCGCGCAGGCCAGAGGGAGG	AT%
GTCGGTGGCTGGCTGAACGATGG	AT%
GGGCTCCTCAGAGCCGCCTGCGG	AT%
GCGCTGGATACTCACGTGACGGG	AT%
AGAAACAGTTTTAGCATAGTTGG	TTTT
AGCTGCTCCTCGGCGTCCGACGG	AT%
CCCGGCCCCATGCCCTGCAGCGG	Multiple matches in exons
CCTGACCTCCATCCAGCTGCTGG	Multiple matches in exons
CTGCTTCAGACTTGGTGGAAGGG	Secondary structure or energy
GTGAGGCCACCAAGGAGATGAGG	AT%
GGCCTTGGCTGTTTCCTCTGTGG	AT%
CTCTCGGCTGCAGCCCTCGTGGG	AT%
GGCTTTATTGTCGCCCCAGATGG	Secondary structure or energy
GTCGCACCTGTCTTCCTCCTGGG	AT%
GCTCGCGCCGCGGGGCTCGGCGG	AT%
CCAGCCTGGGTGGAGGGGTGGGG	Multiple matches in exons
AGCTGGAGGTTGTCTGGTGCAGG	AT%
GGGGGCTTGGGTACCAGGTTGGG	AT%
CTCTCCCCTCTCCAGTGTTGGGG	AT%
GGCCAGGACTGTGGTTTGGGAGG	AT%
ACTCCTGCTGGGCCACATCCTGG	AT%
ATATACTCACTCTGACTCTGAGG	Secondary structure or energy
GTTGGAGCCCAGACCCAGAAAGG	AT%
CCTCAGGATAGGGAAATAGCAGG	Multiple matches in exons
CCATCCCCAGCTTCAGGTGCCGG	Multiple matches in exons
GCCACTAGAGCAGGGAGGCTGGG	AT%
GCTCACCCTTCTGCTCTAGGTGG	AT%
AGTCCCGGGGTTCTGTGTAGAGG	AT%
CCAGCTCAGCTGGGGCCCCCAGG	Multiple matches in exons
AGCTCTGTTGTACCAAGACCAGG	Secondary structure or energy
GCTGTGTGGTCCCGAAGCTCTGG	AT%
CCCTAGAGGCTCTGTGGGGTAGG	Multiple matches in exons
GGGTCTGTGTGAATTGGGCAGGG	Secondary structure or energy
CTTCACCTACCTCATGGGGGAGG	AT%
CAGGGCCCCTGAAGTCTGGATGG	AT%
CCGGGCTGGCTGCCGCGGAATGG	Multiple matches in exons
AGATGATAATAAATATTTTAAGG	TTTT
CACCAGCTGCTGCAACAGCATGG	AT%
GCCTCTTCCCCACCATGCCGCGG	AT%
CAGGGACAGCCTCCGAGCCTTGG	AT%
ATCTGGGGGGAGAGTGGCCAGGG	AT%
ATTCTGAGCTCCATCCTGGCTGG	Secondary structure or energy
CCCTTGTCTCCTTGGAAGCATGG	Multiple matches in exons
GGTTTGCGGCTCCGCCCCACCGG	AT%
GGGATGGTCCGCTCCCAGGGGGG	AT%
CCAGGTCATCCTGCTTGGTGGGG	Multiple matches in exons
AAGTCATGAAGCGTGGACCCTGG	Secondary structure or energy
GCGCTACTTTACTTGGGAGGAGG	Secondary structure or energy
GGAGCCAAAGCAGGAGTTGGAGG	AT%
CCTATGGCAGAATGCAGGAATGG	Multiple matches in exons
GAAGCACAAACTGGAGACCAAGG	Too close to reverse primer
CGAGGCCTGCTCCCTGAACCTGG	AT%
GCATGCCTACAGCACTGAGTTGG	Secondary structure or energy
ACAGCTGAAGTCAGGCGAGCTGG	AT%
AGGAGAGGTCCCATCGCGTCTGG	AT%
CGACCAATGCCTCATCTGGCCGG	AT%
AGGTGCTCATGCAGCATGGCTGG	AT%
ACTTCAGCCGCCGCCACCCGGGG	AT%
CCTTTGTCCGGGTGCAACAGAGG	Multiple matches in exons
AGCCCTTGCCCTGCTGCTGGTGG	AT%
AGACTTGGTGAGCTGCCTGGTGG	AT%
CTGGTAGCATAAAACTTCAGAGG	Secondary structure or energy
CAGCTGTGCTGCCCTGGCAAAGG	AT%
CTTGGTGGGGGTCACCCCAGGGG	AT%
AAAACCCTGCGCGCGAACGGCGG	AT%
CAACATCTTCCACAAGGACCCGG	Secondary structure or energy
GCCCAGCCTCCATGCAGTACTGG	AT%
AAGAGGCTGGGGGAGCAGGTGGG	AT%
GGACTCCCTGTTACTTTTGCTGG	TTTT
AGGGCCAGGCCAGTGGGCAGAGG	AT%
CCTACCCCACAGAGCCTCTAGGG	Multiple matches in exons
CGCCTCACGCGCCTCTACCTGGG	AT%
GAGTCTGGCAGTGTGCTGCAGGG	AT%
ATTGAGGAAGACAACTGTTGTGG	Secondary structure or energy
CCTGAGCTGGACTCATGGGGTGG	Multiple matches in exons
AACTGAAGCCAGGGTTCTGCAGG	Secondary structure or energy
CTGCCTAGAGCCGCCTCCAGGGG	AT%
GGGGGCGGGTCCGAGGGCGGGGG	AT%
GGAATGGGCCCTGCTTTTTGTGG	TTTT
GCCGCCACCCGGGGGGCTCCCGG	AT%
GGGGTCCAGTGACTGGGTTGTGG	AT%
GGGAGCCATAGCAAGCTTGGCGG	AT%
CTCACGCGCCTCTACCTGGGCGG	AT%
GCGGGCCAAGGAGCACGTGCAGG	AT%
GCGGGCACCACTGGCCACCATGG	AT%
CAGCTTGGTAGGAACTTTCTGGG	Secondary structure or energy
GGCGATGACTGGGGACCAAGAGG	AT%
GTCTCCCTCAGCTTCTCCGTGGG	AT%
AGTCCCTGGGCCCTCAACACTGG	AT%
CTCAGTGTCCAGGGCCCAGCCGG	AT%
CAAGACGAGGGCCTCCCTGTGGG	AT%
GTGGGGGTAGGGGTGGGGGTGGG	AT%
GGCTAAGTCACGTGTCTGCTAGG	Secondary structure or energy
GGTTCTGTGCATGTGCCTGGAGG	AT%
GGGCAGGTGGAGGGGTGTGCTGG	AT%
GGCTTTCCATGACGATGATGTGG	Secondary structure or energy
CCACCGCCAGTCTGTCCCGCTGG	Multiple matches in exons
GGCCCTGAAGAAGACTGCTGAGG	AT%
GCACCTGGCGGGTGCCAGGGTGG	AT%
CAGAAGGTAGTGTTTTCTTTAGG	TTTT
CCTGTGGCCTCCTTGCCTAGGGG	Multiple matches in exons
AGAGCTCCTCATCTCCTTGGTGG	Secondary structure or energy
CGGTAGGCGACACAGGCCGTCGG	AT%
ATCGCGTGTGTACTTGGTAGAGG	Secondary structure or energy
ACACAGCCCTCTTTGCTGCTGGG	Secondary structure or energy
CCGCATCCCTACCTCAGCCTAGG	Multiple matches in exons
ACGCCTGCGCAGTTCCTCCATGG	AT%
GCTGTCAGAACATCACTTGGAGG	Secondary structure or energy
CCTCCCTGTAACTCACCCTCAGG	Multiple matches in exons
GTGTCAGGTGACAAGCTGAGTGG	Secondary structure or energy
CTTCAGAAAGGGGCTGCTCTAGG	Secondary structure or energy
GACTTCAGCCGCCGCCACCCGGG	AT%
GCCTGAGACCATTTGGCCTCTGG	AT%
GTCTGCTCAAGAGATTCTACTGG	Secondary structure or energy
GAGGAGGCCATGGAGGGGATGGG	AT%
CGCTGGGTCTGGAAGAAGAGAGG	AT%
CCCCAGCATGCCGATGTACACGG	Multiple matches in exons
GGGTCCTTGCGGAAGCAGTTAGG	AT%
AAGGCAAGGAGGTGAGGCACAGG	AT%
CCTAGCTCCTTTCTGGGTCTGGG	Multiple matches in exons
GGTCACGTACCGGGGTCCGGAGG	AT%
CATTTGGCCCTGGAAGGTCCTGG	AT%
GTCACCTCCACCTGATCCTCGGG	AT%
ATGAGTCCAGCTCAGGGGTGGGG	AT%
CGAGCCAGGAAGCCAGGGAGTGG	AT%
AAGAGACAGATTGGCTCTGGCGG	Secondary structure or energy
ACAGCTGGCCTCTGCCTCGCTGG	AT%
GCCGCGGGGCAGCGCACGCCAGG	AT%
CCTCAAGTTTGGTACCCAGAAGG	Multiple matches in exons
GGGCCTGGCAGGTGGGCTGGAGG	AT%
GCCGAGCTGCCGCGCATGACCGG	AT%
CTCACCGTCCTCCCGGGCCAGGG	AT%
GTCCTTGGCTGGCAGCTCTTGGG	AT%
CTTATTTACCCTACAGGACTTGG	Secondary structure or energy
CTTTGTTGGTAGGGGCTAGGCGG	Secondary structure or energy
GCTGGGAAAGGCCAATCCTGTGG	AT%
CCATGAGCATCTCGCTGGTAAGG	Multiple matches in exons
CTGCCTGTGTGCCGGGAGGGGGG	AT%
AGGTCTGGGTCCAACCCCTGTGG	AT%
AGGGTGGCTGGCACGGCATGGGG	AT%
CCTCCTGGGAACAGCATGACAGG	Multiple matches in exons
AACAGAGGAACACTTTTAGACGG	TTTT
CTACAGCTTTTGCTTTAAATAGG	TTTT
AAGGCTGTCAGAACATCACTTGG	Secondary structure or energy
GGGGTGCCGTAGGTCGGGGGTGG	AT%
CTCAATGCGCACACGGCGCTAGG	AT%
CGCCCCTACCCATCTTCCGCTGG	AT%
AGCTTGGAGCCATGGGGTGTCGG	AT%
GCCCCACTCCCAGCCTCTCTGGG	AT%
GGCAGGTGGGCCTTGCTTTCAGG	AT%
AACTGACCTTGTTCACTACAAGG	Secondary structure or energy
GGAAGCTCATGCGCACGTGTGGG	AT%
GGGGAGGTGGCGGTGGTGGTGGG	AT%
CCTCCCCAATGGGGTCATTGCGG	Multiple matches in exons
GCAGGGCGGGGCCGGTGGGGCGG	AT%
CCAAGTTGGGGAGAAGTCTTGGG	Multiple matches in exons
CCCATGCGCAACAGCGCGGGCGG	Multiple matches in exons
AGTGGCTGTCAGAGTCCCCCAGG	AT%
CCGATGAGGCGGCTACCCCCTGG	Multiple matches in exons
GGAAAGCCAGCAGGACCAGGCGG	AT%
GGGGGAGAGTGGCCAGGGCAAGG	AT%
CCCTCCTCCATTCTTCTGCATGG	Multiple matches in exons
CCGCGCCCACGCCCCGAGTCTGG	Multiple matches in exons
GATCGAGAAGGCTGGACTCGAGG	AT%
AGCCCAGAGAGGCTGGGAGTGGG	AT%
GACTTCTTCAGGGACCTGAGAGG	Secondary structure or energy
AGCAAGCTGTGCTCCTGGGCAGG	AT%
ACACAGGGGTGGAGGAACTAGGG	Secondary structure or energy
GGGATTCCTCCAGGTCCCTGGGG	AT%
GGCCCACTGTCACCTGGCACTGG	AT%
ATCTTGTGCAGGTTGTGACGTGG	Secondary structure or energy
GGTGGCCAGTGGTGCCCGCCGGG	AT%
ACAAAGAAGGCAAGGAGGTGAGG	Secondary structure or energy
AGAGCTGCCTAGGCATGGTGGGG	AT%
GGACAGGCCAGCGCATGGCTGGG	AT%
CAGCTGAGAGTACCATGCCCTGG	AT%
GGTAGGGATATGCCCTGCAGTGG	AT%
CCCTGCCTCACACATCATGATGG	Multiple matches in exons
CTCCTTCCCTCGCTTTATCCAGG	Secondary structure or energy
CTCTGGTGCTGGAGGGCAGGTGG	AT%
AGCCAGTGCCGAAGTACGAGAGG	AT%
CACACACACACACACACACATGG	Multiple matches in genome
CCAGCAGCAGGATGTGAAGCAGG	Multiple matches in exons
CTGGGCCTCCTCCCAGGAAGTGG	AT%
AGCCAGCCACTGGGGTGTGCAGG	AT%
CGGAGGGCCAACTGCAAGAAGGG	AT%
CCAGCCTGTTTGAGGTACGCTGG	Multiple matches in exons
GGAAGGGGCAGCTCTTATCCAGG	AT%
GAACCCCAGAGTGAGTGGCAGGG	AT%
ATCCACCTAATCCCAGGGAAGGG	Secondary structure or energy
GAGACCACCAGCCACCTGATGGG	AT%
GGGCGGCCAGCGGGACAGACTGG	AT%
GGGCAGCTTCTTGGCCTCACTGG	AT%
GTCCCAGATGTGGGGGACAGAGG	AT%
GAGGAGCCCTGTGAGGAGGGAGG	AT%
ACAGCAGCTGGGACACGGTAAGG	AT%
GAAATCATCGAGGCGTCCCTGGG	Too close to reverse primer
ACCATAGGCTGTACAGTAGCTGG	Secondary structure or energy
AAGCACACCTCTGCCTCCTGTGG	AT%
GGGAGAAACGGGTGTCTGTCTGG	AT%
GACCATGTACCGGGACCCGGAGG	AT%
GTCTATCTGTTTTGTACCCTCGG	TTTT
ATGCGGTGAGGGACCAGGCTGGG	AT%
CTAGAGCAAACAGCTGCCTTGGG	Secondary structure or energy
CAGACAGGCTGCCCCAGCAGGGG	AT%
AAGCCTTTCAGCCCCAGCAGCGG	AT%
CAGGGAGGCCCTCGTCTTGTTGG	AT%
CCGTCGGGGCGGCCAGGGCGTGG	Multiple matches in exons
GGTCATGCGCGGCAGCTCGGCGG	AT%
ACCCTCCTTGTTAGTCTCTGAGG	Secondary structure or energy
CGCGGCTCAGATGGAACTCTTGG	AT%
CTCCGACTTGGGGATACACTTGG	Secondary structure or energy
AGAGCCTGGCCGGACTGTACCGG	AT%
CGGAGCAAGGAGCTCAGCCCTGG	AT%
GGAGAGCCCAGCATCCAGAAAGG	AT%
ACCCCCTCTTCTTCGCCCTGGGG	AT%
GAAGCCTTTCCTCACCGCTCTGG	AT%
CCACCCGCATCAGGACACCCAGG	Multiple matches in exons
GCCAGGGCTTGGGCATCTGAAGG	AT%
GACCGTGTACATCGGCATGCTGG	AT%
CCATTGCTCCTGTGCTACCATGG	Multiple matches in exons
GCATGCAGTGGACGGTGAGTAGG	AT%
CTCATGGACCTGACCCCCACGGG	AT%
GGTTAGGAGGAGCAGGAGGCAGG	AT%
CGCTGGCCGCCCTGGGTTTGCGG	AT%
GGCAGCATAAGGGGGTACAGGGG	AT%
GGTCGGTGTTGATGCCCACACGG	AT%
GCCGGCACAAGGAGAGTTGTGGG	AT%
GAAGTACCACAGTCAGGTGAGGG	Too close to reverse primer
GACCCGGAGGCGGCCAGCCCAGG	AT%
GGCAGCTGCCCGTGGGCCTCAGG	AT%
ATATACAGCCTAAAGCAAGGGGG	Secondary structure or energy
CTCCCATCCTGAGCTCTAAATGG	Secondary structure or energy
GAAAGTGGTGATCAGTATCCGGG	Secondary structure or energy
GGAGGCTGGGATGGAGGAGGAGG	AT%
GGCCCAAGAGCTGCCAGCCAAGG	AT%
GACAGGCGGCAGGGCAGCTCTGG	AT%
ACCAGTTGTTGAAGGCTGATTGG	Secondary structure or energy
CATCCTGAGCTCTAAATGGAAGG	Secondary structure or energy
GTCTGAATAGACGTTCTGTGTGG	Secondary structure or energy
AGGGTGCCTCAGCCAACTGGTGG	AT%
GGACTCATGGGGGTCCAGCCAGG	AT%
CAGATCCAAGCAATAATAGGAGG	Secondary structure or energy
CTCCCCCTCCCCCCAGCCTGGGG	AT%
CCCGGTGCCGACCCCTGGCCCGG	Multiple matches in exons
GGAGGAAATCACTTCCCTGGAGG	Secondary structure or energy
CCTTCCCTGGCCTCTGGTGCTGG	Multiple matches in exons
ATCTCATTTTGCAGTCAAATTGG	TTTT
GGGCCGGGGCCCGTGACCATGGG	AT%
CACATGTGCCCTGAGTGGCCTGG	AT%
AGCTCGGGGGGCACCAGACCCGG	AT%
AGGAGGCAGCTCAGTCACACAGG	AT%
GGATGTGCTGCAGAACGAGGAGG	AT%
GCTGAACCAGTCATTGAAGAAGG	Secondary structure or energy
AGAGCATCGAGGAGATCGTGAGG	Secondary structure or energy
CTCCGGGCACCCTCGGGAAAGGG	AT%
CGAGCCCTGCGGCGGGCCGGAGG	AT%
CGCACCTGTCTTCCTCCTGGGGG	AT%
ATCAGTCAGCGTTTTCTGCAGGG	TTTT
CTCTGCTGCCAGTCGCTCCTGGG	AT%
CCAGTGGCTGGCTTATCCCAAGG	Multiple matches in exons
GCTTACCTTAGCAGGCCTCCTGG	AT%
AGGGGCGCCCCCAGCGGTGCGGG	AT%
CCCCGAGGAGCTGAGTGGGAAGG	Multiple matches in exons
GAGCCAAAGCAGGAGTTGGAGGG	Secondary structure or energy
GAAATAGTCCTTATATTTAAAGG	Secondary structure or energy
CTTCCCTTGACTGGGGAGACTGG	AT%
GCTGCTGGTCCCAGATGTGGGGG	AT%
AACCTGGTGGACCACGGCCGAGG	AT%
CCTTATATTTAAAGGACTTAGGG	Multiple matches in exons
GGCGCTCGACTTCAACAAGCTGG	AT%
GCGCGGGCTGCACCGAGCCGCGG	AT%
AATGAGACCTTTCTATTTGAAGG	Secondary structure or energy
CCCACTGGGAACTGGGCTCGGGG	Multiple matches in exons
CCTTGTAGTTAGCGTCATACAGG	Multiple matches in exons
CCCCGTGCGCTACGGCCTCCGGG	Multiple matches in exons
CAATGCCTCATCTGGCCGGTCGG	AT%
GGGCCCTGACTCTGCAGCCAGGG	AT%
AGCTGGCCTGCCAGTTCTCAGGG	AT%
GCGGCAGGGCGGGGCCGGTGGGG	AT%
GATCCAGTGCCAGGTGACAGTGG	AT%
CGCCCCTGGGGTCACCATTGAGG	AT%
CGGCGGCCGCAGCGGCAGGGCGG	AT%
ACCCCACAGCTGAGGTGGCCTGG	AT%
CGTTTGTTTCCTCACAGCTCGGG	Multiple matches in exons
CCACCATCACCTGACCTAGGGGG	Multiple matches in exons
AAGCCCTGGCCAGAGCCCCAGGG	AT%
GACGATGGGGCAGGGCTGGCTGG	AT%
CCCGGCACACAGGCAGGCCGGGG	Multiple matches in exons
GCAGGACAGGGTAGTGAGGTGGG	AT%
GGGTGAGAGCGAGATGCCAGAGG	AT%
AGCCAACCCCAACAAGACGAGGG	Secondary structure or energy
GTCTGGCCACAGACAAGATCCGG	Secondary structure or energy
GTTGAAGGAGGCTTGGGGCAAGG	AT%
CGCTCTTACGGCGGCCGCAGCGG	AT%
GGGCCCTGATCGACATTGTGAGG	AT%
CTGCCACCATCGAATCCGCCTGG	AT%
CGGCCCCATGGCAGCATAAGGGG	AT%
AGGCCCAGAGCCCCCCAGGAAGG	AT%
CATGCGCACGTGTGGGAAAGGGG	AT%
AGTCACTGGACCCCCGCGGGTGG	AT%
ACCCTATTTTATTGTTAGACCGG	TTTT
AGACACTGAGGGAGGCGAGGTGG	AT%
GGGTGGTGGGGTGGCCCCCCGGG	AT%
GGCTGCCCCAGCAGGGGGTGAGG	AT%
CACCCACTGTTTGCAAGGTCTGG	Secondary structure or energy
CTCCCCTCGGCTCCCCTATAGGG	AT%
CCGGCCCCGCCCTGCCGCTGCGG	Multiple matches in exons
AGCTCACTCCCTATCGCCCTGGG	AT%
GAATTCTAGCACCTGAGGGCTGG	Secondary structure or energy
CCTGCTCAGCTTCTATGACTTGG	Multiple matches in exons
CACCAGATCTGGGGGGAGAGTGG	AT%
CACTGGGCCACAGGCTGCCGGGG	AT%
ATCTTATGGGCTGGACACAGTGG	Secondary structure or energy
GTTCTCTATGGTTTTCCCATTGG	TTTT
CACCCCTGAGCTGGACTCATGGG	AT%
ACACCCTGTCCCCAGGGACCTGG	AT%
CACCTTATTGGCCAGTTTAGGGG	Secondary structure or energy
AGAGGAACACTTTTAGACGGCGG	TTTT
CAGTGAAGGCTGAGAAGAGAAGG	Secondary structure or energy
AGCACAACCTGCGCACCGACCGG	AT%
GTAGCAGGACTGGAGACGGGAGG	AT%
GGCTGTCAGAGTCCCCCAGGCGG	AT%
AGGTTGTGCATGGTAGTGTCAGG	Secondary structure or energy
AGGGATGGACACCTCCCCAATGG	AT%
GCTGGCAGCCACCTGCAATGTGG	Multiple matches in exons
GGGGCAGTTGAAAGTGAGTGTGG	Secondary structure or energy
GATCAATCTCCATGACAAGGTGG	Secondary structure or energy
CTGGGGGCCCCAGCTGAGCTGGG	AT%
GGAGCGCACGAAGCGGGTGCAGG	AT%
GAAGCAACTGCAGCAGGCTCAGG	AT%
GAGCCATGGGGTGTCGGTGCTGG	AT%
CCTCCACAGATGACTCCCCCAGG	Multiple matches in exons
CCCTGCATGGCTGCAGTAAGAGG	Multiple matches in exons
GTCCTTACACTGGAGTTGCTGGG	Secondary structure or energy
GGTTGTCTGGTGCAGGTTCCAGG	AT%
CTTACGGCGGCCGCAGCGGCAGG	AT%
CAAGGGGGAGATTAGCCCAGTGG	AT%
GCCATTAGCTGAGATGCCCCAGG	AT%
CTGGGTGTAACCCCAGGAAAGGG	Secondary structure or energy
CCTGCTGGTGCAGGTTGCTCGGG	Multiple matches in exons
GGCCACAGGGAGTGGAGAGAGGG	AT%
CCTACATGGCTTCCCAGGCGGGG	Multiple matches in exons
CCAGGGGGTAGCCGCCTCATCGG	Multiple matches in exons
CTATCTGAAGCAGATATGATTGG	Secondary structure or energy
GCAAGCCCAACCCTGACCAGAGG	AT%
ACCCTGGCTGTGCCCATGTAAGG	AT%
GGTCTTCCACCATGGCCGTGTGG	AT%
AAGAAGAAAGCAAAGACTGGGGG	Secondary structure or energy
GGTGGGGGTAGGGGTGGGGGTGG	AT%
GCAGACAGGCTGCCCCAGCAGGG	AT%
CCTGGGTCTGCTGGGTGTGATGG	Multiple matches in exons
CTTGGCTCAGGTTGTGTCCTGGG	Secondary structure or energy
CTTCTAGGGTCAGGCAGGGAGGG	AT%
GCGATGCCGGGTGGTGGCAGCGG	AT%
GGCAAGGCTGTGACAGTCCCAGG	AT%
GAGCCGCCAGGGCAGCACCCAGG	AT%
CATGGTGGGGAAGAGGCTTTGGG	Secondary structure or energy
ACTATCTCCAGCCTCGCTCCCGG	AT%
AGCCTCCCTGCTCTAGTGGCTGG	AT%
CTTGCTCTGCCCTCCAGGAAAGG	AT%
CCAGGAAAGGCCTGTGAGGGCGG	Multiple matches in exons
GGGAACTATCATAGCTCTGGTGG	Secondary structure or energy
GAGGGGGCCATGGCGCCCAGGGG	AT%
CAGCCATCCAGCTTGGGCCTAGG	AT%
CGGCGGGCAGCGCGCGCAGCCGG	AT%
GTGGTGTGCTGCTGCTGACAGGG	AT%
GCAGGACCAGGCGGGCAGACAGG	AT%
CCTGCGCTCTGAAGAGGACCTGG	Multiple matches in exons
CCAGAGCTGCCAGCCATGCCCGG	Multiple matches in exons
GCTATATCCAAGCCAGAGTGTGG	Secondary structure or energy
GACTTGCGGGAGAAGGACAGTGG	AT%
CATGGCAGGGGTGCCGGGCTGGG	AT%
CCGGGGGCGGGTCCGAGGGCGGG	Multiple matches in exons
GGGGCCCCCGGCAGAGTTGGCGG	AT%
AGCCAAACGCAATGCGGTGCTGG	AT%
CTCAACTGCAACAACAACAACGG	Secondary structure or energy
AGAAGGCGAGCCAGGAAGCCAGG	AT%
CCAGGGTGTCCAGGTGCGGTTGG	Multiple matches in exons
AAGGTCTAAGAGAGACACTGAGG	Secondary structure or energy
GTATTTTTAGGATCCTTTTGTGG	TTTT
CCCCCAGATCTGGTGCCTGCTGG	Multiple matches in exons
AGGTCTAAGAGAGACACTGAGGG	Secondary structure or energy
GGGGGTCCTAGGCTGAGGTAGGG	AT%
CCAGGCAAACAATGACATCTTGG	Multiple matches in exons
GTCATCCACTTCCCATGTTCTGG	Secondary structure or energy
GCTTTCAGGAGGTGAGCGCCTGG	AT%
AGGGTTTCCCTACGAGAAAGTGG	Secondary structure or energy
CCAAAGGCCCCCTATGCCCCAGG	Multiple matches in exons
GCCGGTCATGCGCGGCAGCTCGG	AT%
GAAACGCTCTATGAACAGGCAGG	Secondary structure or energy
GCGTGCGCTGCCCCGCGGCCCGG	AT%
GCCAGGGGTCGGCACCGGGTCGG	AT%
CCATTTGATGGATTGGTAGTTGG	Multiple matches in exons
CGGGAGGGGCCCGCACCGCTGGG	AT%
CTTGGGGACAGGAAGCAAGTAGG	Secondary structure or energy
AGCCCCAGAGGAACCCAGCCAGG	AT%
CAGCTGCCTGGCGCAAGGCTCGG	AT%
CGAGCTGCCGTCGGACGCCGAGG	AT%
GGGGCCGGTGGGGCGGGCGGAGG	AT%
AGAAATCATCGAGGCGTCCCTGG	Too close to reverse primer
GGTGCTGGAGGGCAGGTGGAGGG	AT%
AGAGGTGGGCCCGTGGGCAACGG	AT%
GCTACGGCCTTCCTGCCACAGGG	AT%
ATGGTGGAGCCCGCTGGAGCCGG	AT%
AGAGTCCCTGGGCTGACCTCTGG	AT%
CACTCAGGGCACATGTGCTGTGG	AT%
GGGGACCATGTACCGGGACCCGG	AT%
ACCCTCTGCAGCAAGCTCTGAGG	AT%
CGCGGCGGGCAGGCGGGCCATGG	AT%
CCGGGCATGGCTGGCAGCTCTGG	Multiple matches in exons
GCCCTTCTTGCGCATGTTGTTGG	Secondary structure or energy
AACTATCATAGCTCTGGTGGTGG	Secondary structure or energy
CCTGGTGGGCCCCAGAGCCCTGG	Multiple matches in exons
GTCATGCGCGGCAGCTCGGCGGG	AT%
GCACAGAAGATAAAAATCACTGG	Secondary structure or energy
CACGGGGCATCCGGGTAGACTGG	AT%
CCCTAAGTCCTTTAAATATAAGG	Multiple matches in exons
CTGCTGATGCAGCAGCCACTGGG	AT%
GGACAGGACTTTCATGGCTTGGG	Secondary structure or energy
GCCCAGAGAGGCTGGGAGTGGGG	AT%
GCTAGCGTGCCGAGATGACCAGG	AT%
AGCAGAGCTGCAGTCCCGGCGGG	AT%
CAGTGGGCGGAAAAGCCCTGTGG	AT%
CAAACCACTTCTCAGGTTAATGG	Secondary structure or energy
AAGGTGTAAGGGCCACAGGCTGG	AT%
CCCACCACTCCTCTTGGGTGTGG	Multiple matches in exons
AGCTGGGATTGGAGGGACTGGGG	AT%
CCCGGGTTCTGAGGAGGATGAGG	Multiple matches in exons
CACTTGAGGGTCGGGTACTGGGG	AT%
GGTAACTATTTGTTTTACAATGG	TTTT
GCGGCAGCGTGCTCCGCGGGCGG	AT%
GGGTGGCAGGGAACGGGCACGGG	AT%
CCGATGACACGGTGGCCCCCCGG	Multiple matches in exons
CCACGCAAGCAGAGGAAGCGGGG	Multiple matches in exons
GGGACACAGAGGCACCTGGTTGG	AT%
GCACTGTGAAGTCAAGGCAAGGG	Secondary structure or energy
CAAATCTGCTTCAGACTTGGTGG	Secondary structure or energy
ATGTTGCAGACACCAGCACTGGG	Secondary structure or energy
GGCTTGGCAAAAGCAGGGCCTGG	AT%
AGACCAAGGTGCTCGGAGCAAGG	AT%
GAAGAAGTTGGAGCAGGAGATGG	Secondary structure or energy
GATGCCCTGACTGACCTGACAGG	AT%
GGAATTGGGAGGGCCTACCTGGG	AT%
CGAAAGACTCATTGAAGATGGGG	Secondary structure or energy
CCTCCTGTCACGATGCGGTGAGG	Multiple matches in exons
CATCCAGTGTTGAGGGCCCAGGG	AT%
AGCTCCCCCGAGGAGCTGAGTGG	AT%
CCTAGGTAGGTTTGGCATGACGG	Multiple matches in exons
CCGTAGCGCACGGGGCATCCGGG	Multiple matches in exons
ATGAGCTGCCCGGCACAGGCAGG	AT%
AAAGGCCAGGACTGTGGTTTGGG	Secondary structure or energy
GCCTGACTCCTCTGTATGGGCGG	AT%
CTCCTGTCACGATGCGGTGAGGG	AT%
AGCTAGCTATCTGCCCTAACAGG	Secondary structure or energy
GCCCCCGGGCCAGGCTGTAGCGG	AT%
AGAGCTGCTGGGCTTCCTTGTGG	AT%
CACGTACTGCATGGAGTCCCGGG	AT%
CAGGACAGGGTAGTGAGGTGGGG	AT%
GCCCCATCCACCTAATCCCAGGG	AT%
GGCCCCAAAAAGGGGATCTAGGG	Secondary structure or energy
GCGGCATGACGTCTCTGTTCTGG	AT%
GTGGCCCCCCGGGTGCCGCTGGG	AT%
CCTTCACAGGCACCGGTTAGAGG	Multiple matches in exons
CAGCTTGGGCCTAGGGAAAGAGG	AT%
AGGGAGGTACCCAGACGCGATGG	AT%
GGCGCAGAACGCCTTGACCAGGG	AT%
ATGCCCAGGACTGAGCCATCAGG	AT%
CCAGGACTCTGGCCATTCAAAGG	Multiple matches in exons
GAGCTCCTAAGGAAGAAAACAGG	Secondary structure or energy
CTTTTCTTCATTGTCAGGTATGG	TTTT
GAGTAGCTCAGAGCAGGCAGAGG	AT%
CAACACCGACCGGCCAGATGAGG	AT%
AGTGGGCGGAAAAGCCCTGTGGG	AT%
GGCGGGCCGAGCCCTGCGGCGGG	AT%
CTGCAGGAGGCCTGGAGGGAAGG	AT%
CAGGTCGGCCTGCTCACCTCTGG	AT%
CACGCCAGGCTCGCGAACTAGGG	AT%
CCTACGAGAAAGTGGTGCAGAGG	Multiple matches in exons
CCCAAGGGGCTGGATCGAGAAGG	Multiple matches in exons
ACTTCGACACCCAGGATCACGGG	Secondary structure or energy
CGACAGTCCTCCATGACCACCGG	AT%
CGGTCCCTAGAGGCTCTGTGGGG	AT%
CACCCTTCTAGGGTCAGGCAGGG	AT%
GTGAGGCTGGACTCCAAGGGAGG	AT%
GAAGCCACCGCACCGGAGACAGG	AT%
GAGAAGCGCGCGGCCGCAGGCGG	AT%
CTGAGAAGAAGTGGGGACCAGGG	Secondary structure or energy
CAAAGTCTATGCTGCGGCCACGG	Too close to reverse primer
CTGGGGCTCCCTTACCAGAGGGG	AT%
CTGGGACCGCTGGCGATGACTGG	AT%
CTACACTGAGCAGCATCCCGGGG	AT%
CAGGCCTGGGGCCATGCCCTAGG	AT%
AGTACTGGACCCAGAGTCTGTGG	Secondary structure or energy
CGAGAATATCCCCAAGGGGCTGG	AT%
CGTTCAGCATTTGGGCATTGAGG	Secondary structure or energy
GGTGGCTGCCAGCTGCAGAGGGG	AT%
ACTGAAATGGAGCCGCCCCACGG	AT%
GATTGGAGAGCTAGCCCCAGAGG	AT%
CAGCCTGTTTGAGGTACGCTGGG	Secondary structure or energy
GGTACGTGCCAGGCCACTCAGGG	AT%
AGGGAGGCCCTCGTCTTGTTGGG	AT%
CCGTAGGTCGGGGGTGGGAGGGG	Multiple matches in exons
GCAGCTGTGGGTGGAGCTCACGG	AT%
CAGGTACATGGGCCAGCCATAGG	AT%
GCCGACGGAAACCTTCCAGCTGG	AT%
ACAGGCGGCAGGGCAGCTCTGGG	AT%
ATGGGGCCGGGCGACCCCCGGGG	AT%
AGTCCCCCAGGCGGATTCGATGG	AT%
GTCTGGGGGGGGGTCCTTCTAGG	AT%
CCATGAGTCCAGCTCAGGGGTGG	Multiple matches in exons
GATGCCGTACTTGGCGCACAGGG	AT%
GCATCCTCTACACAGAACCCCGG	Secondary structure or energy
CAATGATACGCTCTGAGATCTGG	Secondary structure or energy
CTACTTTCTCCCCCAGCTGCAGG	AT%
GATCTGAAGCCATGCAGCGATGG	Secondary structure or energy
AGGAAAGGGGACCACAGGACTGG	AT%
GGCCAAATGGTCTCAGGCCCTGG	AT%
GCAGCTCTGTGCGTGAGCTGAGG	AT%
ACAACTCTCCTTGTGCCGGCTGG	AT%
CGGGCGGCCCGGAGGGCTGGCGG	AT%
CATAGTGGGGAAGAGGCTGGGGG	AT%
GGGAGGCGAGGTGGCAATCAGGG	AT%
GCTTGGGGCTGGGGCAGGCTTGG	AT%
GGTTACACCCAGCTGGGCAAGGG	AT%
GAGGCCCTGTGCCAGTGGTCAGG	AT%
GCAGGGCTTGGGCTGGGTTGCGG	AT%
GGCACATGTCCAACAGGACCAGG	AT%
GCTAGGCTGAGGCACTGCCTCGG	AT%
AGCCCACTGGGAACTGGGCTCGG	AT%
GAGGAGAGCAGCAGACGATGGGG	AT%
AGGGGCAAGGATCCAGTGCCAGG	AT%
CGTAGGTCGGGGGTGGGAGGGGG	AT%
GGACTCCACCCCAAATCCCACGG	AT%
CGCAGTAGTCGCTACCCAGCAGG	AT%
CGTAGATGCCAACCCAGAGCAGG	AT%
CAAATGGTCCCAGCGGCACCCGG	AT%
GGCCTTGAGGAGGCCATGGAGGG	AT%
CAAGATCAATCTCCATGACAAGG	Secondary structure or energy
CAGGGCTAGCTCCGGATGGCTGG	AT%
GGAGGGCACCGGAGTCTCTCAGG	AT%
AGATCCTGAGGCCAAGTGAGAGG	Secondary structure or energy
GCAGCTCTGGGAGGCTCAGCGGG	AT%
CCCCGAGGCCGGAGCGGCCCGGG	Multiple matches in exons
AGGGCTCCTCCTCCGATGTCAGG	AT%
AGTCTATGCTGCGGCCACGGAGG	AT%
GGTGGCGGTCGCAGTGGCCGCGG	AT%
GTAGCCCAGCTTGGAGCCATGGG	AT%
CCGCACCGTGGTGGCCGATGAGG	Multiple matches in exons
CCTCCCGGTACACCCTTTCTAGG	Multiple matches in exons
GTCCGAGGGCGGGGGCCGCGCGG	AT%
CATCGACCCGGCCATTCCCGAGG	AT%
GTCTCTCCCCTCTCCAGTGTTGG	AT%
AGACAGCACCTGGAATGGGGTGG	AT%
GAAGAAGACCTACTCATAGGAGG	Secondary structure or energy
GTGTGAATTGGGCAGGGCTTGGG	Secondary structure or energy
AGCTCTAACCCCAAGCACTCAGG	Secondary structure or energy
GCGGCACAACTACCACAAGGTGG	AT%
AGTGTGCTGCAGGGGGCCGGAGG	AT%
AATTGGGCAGGGCTTGGGCTGGG	AT%
GCTGAGGGACGGGTTCTCCTCGG	AT%
CGGTGGCCCGTGGGGGAAGGAGG	AT%
ATCCTTTAGCTTCAGCTCCTGGG	Secondary structure or energy
CATGACAATGATCAGCCGCAGGG	Secondary structure or energy
GCGCGCCGCCAACTCTGCCGGGG	AT%
CGTGGAGTGCAGAGGGTTCATGG	AT%
CTCATACTTGATGCCGTACTTGG	Secondary structure or energy
CTACTTTACTTGGGAGGAGGTGG	Secondary structure or energy
CAGGGAACGGGCACGGGGAGGGG	AT%
GATGGGGCTCTGGCAGGGTGTGG	AT%
GGAAAATTTTGCTGGCTTAGAGG	TTTT
CTCTGGAACGGGGTACTTGCTGG	AT%
GCCAGGCTGTAGCGGGGCTGCGG	AT%
AGCACTTGAGGGTCGGGTACTGG	AT%
AGGCTCCAAGGGCCAAGGCCTGG	AT%
CACAGGACTGGAGCCCAAGGAGG	AT%
GTGCCTGCTGGCCAGCCCCCTGG	AT%
GAGTCGTGTGCTGGCCAGAGTGG	AT%
CTCTCCTCTCTCACCAAACTTGG	Secondary structure or energy
GGGATGGACACCTCCCCAATGGG	AT%
CCAATGCTGTTACCACATCCTGG	Multiple matches in exons
ATGGCTGACTCACCCTGGCCCGG	AT%
GTTCTAGTCTCAGCAGAGGCGGG	Secondary structure or energy
AGGATTACAAACCTGCAGAGGGG	Secondary structure or energy
GCCCGGCACAGGCAGGCCTGAGG	AT%
GCAAACCCAGGGCGGCCAGCGGG	AT%
CCCAACTCCCTTGCCCAGCTGGG	Multiple matches in exons
AAATGTCTCCAATCTGAACAAGG	Secondary structure or energy
CAGGCCGTGGCCAAACGCCTCGG	AT%
ACACAAACCAGTGGCTCTCCAGG	Secondary structure or energy
AATATGCAGTGACTCAAGTGTGG	Too close to reverse primer
AACGGTGTCTGCCACCCGCGGGG	AT%
CCTCCTTGGAATGTGGTCCAGGG	Multiple matches in exons
ACCAAGGAGTAGGACAGAACTGG	Secondary structure or energy
GTGGAGGGAGTCTGGCGGTTGGG	AT%
GCTTCCTCTGCTTGCGTGGTGGG	AT%
GGCAGAGACAGCACCTGGAATGG	AT%
AGTTGTAGCCAACACTGAACTGG	Secondary structure or energy
AGAAGCCTCCACTTCCTGGGAGG	AT%
CACGCGGCGCGCAGGCCAGAGGG	AT%
GCCGTAGCGCACGGGGCATCCGG	AT%
GTAAGAGTGGGGCCAAGGGCAGG	AT%
ATGACCAGCCACTTGTCGCCTGG	AT%
CCTCCACCAGCTGGCCAGCTGGG	Multiple matches in exons
AAGGTAGGAGAGGAAGGGTATGG	Secondary structure or energy
GCCTGTGCTGCACTATTGCCGGG	AT%
CTGCCTTGACCCCCTAGGTCAGG	AT%
GCCCTGGACAGAGCAGGGAGTGG	AT%
GGCGGTTGCGGTCGAGGTCTAGG	AT%
GGCTGCAGCCTTGGGGGTGGGGG	AT%
GCAGGTGGGACACGTAGCAATGG	AT%
GGCCCAGAGCCCCCCAGGAAGGG	AT%
GGCAAGGAGGCCACAGGGAGTGG	AT%
AGCCTCCCTTGGCCCCACTCAGG	AT%
CGGGAATGGCCGGTGGCCCGTGG	AT%
GGGCAGGCGGGCCATGGAGGTGG	AT%
CTGGCCAGCTGGTGGAGGAGAGG	AT%
CCTGAGACCATTTGGCCTCTGGG	Multiple matches in exons
AAGCTGAGTGGGCCTCAGTGTGG	AT%
GGGAGGAGAGCAGCAGACGATGG	AT%
AGTCTTGATCTGAGAGTGAGCGG	Secondary structure or energy
GATCCTGGAGGACCCTGGAAGGG	AT%
CTGCCGCCGCTGCAGGGCATGGG	AT%
CCTGCGGTTAGTCGACTGGGCGG	Multiple matches in exons
ACGTACTGCATGGAGTCCCGGGG	AT%
AGGCCTGTTCTGATTAATAAAGG	Secondary structure or energy
GTGGGAAGTTGTGATTCCTATGG	Secondary structure or energy
ATGAGGGTGTTAAGGGATGTTGG	Secondary structure or energy
GTGGTAGTTGTGCCGCGGCATGG	AT%
CCTAGGTTTTTCCAGGGGACTGG	Multiple matches in exons
GGGTCTTTGTGGAAGATGTTGGG	Secondary structure or energy
ACCTTGGTGGGGGTCACCCCAGG	AT%
ACAGTGACTCAGTGTCTGAGAGG	Secondary structure or energy
CCTGCCTGTGTGCCGGGAGGGGG	Multiple matches in exons
GGCCACAGGGAAGGTAGGAGAGG	AT%
GATGGTGGCAGGTACGTGCCAGG	AT%
GAGGGTGGCCCCCCTGGTCAAGG	AT%
ATCTGTGCTGGGGGGTTGGGGGG	AT%
GAAGGTCCACTTCGACACCCAGG	AT%
GCCACAGGCCCAGCTGATCGAGG	AT%
GGGGGTCTGAGGAAGAGATGGGG	AT%
AGCAGCAGACCTCCATATGGAGG	Secondary structure or energy
AGGAGTCAGGCTGAGGGCTGAGG	AT%
AGCCTCCTGGGTCTTCCTTCTGG	AT%
GCTCCCGGTACAGTCCGGCCAGG	AT%
GAGCTGCTACTCTGGGGTGGGGG	AT%
CTCGGGCCCCTCGGATGCCTTGG	AT%
CTCGGGAAAGGGGCACTGTTGGG	AT%
GCGTCCGACGGCAGCTCGTCCGG	AT%
CCGCCCCTAAGCCCTTCCTGGGG	Multiple matches in exons
GATGAACTCAATCACCAAGATGG	Secondary structure or energy
CGGCCAGCGGGACAGACTGGCGG	AT%
CAGGGCCCTGGGAAGAAAGAAGG	AT%
AGTTTGGTGAGAGAGGAGAGGGG	Secondary structure or energy
CGTGTGCATGGCCTTCCAACAGG	AT%
GATCTGGGGGGAGAGTGGCCAGG	AT%
GCATAGTGGGGAAGAGGCTGGGG	AT%
GAGTCTGCAGGGTAAGAGGCCGG	AT%
GCACTGACCTCCTTGGAATGTGG	Secondary structure or energy
GGCTTTCAGGTGCGGGCGCCAGG	AT%
GTCTGGGGACAGTGTGTGTGTGG	AT%
GCCTGGGTAAGGGACCCCCACGG	AT%
GGGTGATAGAAGGGGTCAGGCGG	AT%
GCATGGGCAGGGATCTGTGCTGG	AT%
ACTCCACCCTGGCACCCGCCAGG	AT%
CACTCAGGGCCCAGTAGCTTTGG	AT%
AGGCGTGGAAGGCATCCTGAAGG	AT%
GCCCTGGATGTAGGACGGGATGG	AT%
GTGAGGGTACTGGCTACTCAAGG	Secondary structure or energy
GGGAGCCCCCCGGGTGGCGGCGG	AT%
CCATCTTCACTAAGTCCAGGTGG	Multiple matches in exons
CCCCTAGGCAAGGAGGCCACAGG	Multiple matches in exons
GGTCTCCGTGGGATTTGGGGTGG	AT%
GTCAATCTGAACTGGAACGGAGG	Secondary structure or energy
GTCAGGGATGGCGCTGGGTCTGG	AT%
GCACCAGCTGAAAGCCTGAGTGG	AT%
CCTGTTGGCTGGGGGACTTGGGG	Multiple matches in exons
ACGGTTGGGAGAGGCTGGTGTGG	AT%
GATGCTACGGTAAGAGTCTGGGG	Secondary structure or energy
CACAAGTTCAAAGGCAGCCAAGG	Secondary structure or energy
ATGGTCCTGTCCCAGGCCTTTGG	AT%
CCAGCTCAGGGGTGGGGGCTTGG	Multiple matches in exons
GCGCTGCAGCGCTTCTTCGAAGG	AT%
GTTGATTCATCTCTTCTAATCGG	Secondary structure or energy
ATAGGCCTGAAAGTGGGAGGGGG	Secondary structure or energy
CATAGAGGAGTCCTCACCATAGG	Secondary structure or energy
CCAAGGGCAGGATCTGTAGCAGG	Multiple matches in exons
GCCACCAGTTCCCACCCCTGGGG	AT%
AGCTTCCAGTTGAGTCTGCAGGG	Secondary structure or energy
ATAAAGTGGTAGGGGCATGATGG	Secondary structure or energy
ACTGGAGTTGCTGGGCCAACTGG	AT%
ACCGTTTTCCTAGTGGGCGAGGG	TTTT
CTTGGAGTAGGAGTAAGAGTGGG	Secondary structure or energy
CCTGCCCGCCGCGTGCGCTCCGG	Multiple matches in exons
CCCGAAGGGAGGTGGGGTCAGGG	Multiple matches in exons
AGCTGTATGTGAGCGGCACCGGG	AT%
GTTGGCGGCGCGCGAGGACGCGG	AT%
CCTGGGGCATAGGGGGCCTTTGG	Multiple matches in exons
GTTTGTGACTGCTGTGGTTCTGG	Secondary structure or energy
GCACATGTGTACACGCATGTGGG	Secondary structure or energy
AGCCAGCCCGGCGTCCAACCCGG	AT%
GAGGCACCTGCACCCCCATGTGG	AT%
AGAGGACGATAGTGACGCTAAGG	Secondary structure or energy
AAGCTGTTTTATCCCCTCTCAGG	TTTT
GAGGTAGTCAGGGCTAGCTCCGG	AT%
CCACTCCTCTTGGGTGTGGGAGG	Multiple matches in exons
AGAAAGGGGCTGCTCTAGGGTGG	AT%
CAGCTCAGCTGGGGCCCCCAGGG	AT%
CAGGTCAGTCAGGGCATCCTTGG	AT%
GGCATCTCCTGTAGGAGCTGAGG	AT%
AGTTGAAAGTGAGTGTGGAGCGG	Secondary structure or energy
ACTGGGGAATTGTGGGGGTGGGG	AT%
CGGCAAGGTAGGACTGGGCTGGG	AT%
GGCTGTGGCACTGCCTCAGGAGG	AT%
GGATGGAGCTCAGAATGTGAGGG	Secondary structure or energy
GGTGGCTCTCAGCTTGACGAAGG	AT%
AGGTAGGTAGTCAGGCCCAGTGG	AT%
ATGTGTTTACAGAATCTGCTGGG	Secondary structure or energy
GCCGCGGCACAACTACCACAAGG	AT%
GAGCTTGAATTCCTTCCTTGAGG	Secondary structure or energy
GCCGCTGCAGGGCATGGGGCCGG	AT%
ACCACGCAAGCAGAGGAAGCGGG	AT%
GTCAGGGTAGGTCTGGGGGGGGG	AT%
AATCATCCCTACTCTGACTCTGG	Secondary structure or energy
ACCACGTGGATGATGCGGCCAGG	AT%
CGAGGCGTTTGGCCACGGCCTGG	AT%
GGCCCAAGCCAAGTCCTGTAGGG	AT%
GGACAACTAAATACATGACTGGG	Secondary structure or energy
AGGTACGTGCCAGGCCACTCAGG	AT%
AAATGGCCACAAGGGGGTGCTGG	AT%
GTTCTGGGGGTCCTAGGCTGAGG	AT%
CGGAGGGAGCCGGCGACGAAGGG	AT%
CCAGACACTCCTGGCTGCTGAGG	Multiple matches in exons
GGCTGCAGAGTCAGGGCCCTGGG	AT%
CGCAAACCCAGGGCGGCCAGCGG	AT%
AAGAGGAAGGCCGAGGCGTTTGG	AT%
GTCACCCTCACACAGCACAGAGG	AT%
CCAGGAATCATGAGTTGGTCAGG	Multiple matches in exons
GATGTTCACGATGATGGAGTTGG	Secondary structure or energy
CTGGAGGACCCTGGAAGGGGTGG	AT%
GAGTTGCCCTGACTCCTTCAGGG	Secondary structure or energy
GGAGCTGCCCGAGGATCAGGTGG	AT%
GCGGTGATCTGTGGGCAGAATGG	AT%
CCTGGGGGAGTCATCTGTGGAGG	Multiple matches in exons
CATGACAGTGATGATGATCGTGG	Secondary structure or energy
GGAAGACAGCCGGGTTCACTGGG	AT%
GCCCCTTTCCCGAGGGTGCCCGG	AT%
ACTCCCTGCAGAGGCTGTGTGGG	AT%
CCTTAGCAGGCCTCCTGGTGGGG	Multiple matches in exons
ACCAGCACTGCTCAGCAGGATGG	AT%
GCCAGAGCTCAAGGCCTTGTGGG	AT%
CAGAGCCCCTTCCATCCTTGGGG	AT%
ACTTCAGGAACAGGGCCTCCTGG	AT%
CCAAGATGTCATTGTTTGCCTGG	Multiple matches in exons
CGATGCCGCGCCCCCGGGCCAGG	AT%
CAAGCTTGGCTTCTTCCCCCAGG	AT%
AGCAGCTGGAGCTGAGCGGGCGG	AT%
CCTCCAGGAAAGGGGACCACAGG	Multiple matches in exons
CTGCCCAGCGTACCTCAAACAGG	AT%
ACTCCCAGGAACATAGATCTTGG	Secondary structure or energy
GGTTTTGTTTAGCTTTTCTTTGG	TTTT
CCTCTTCTTCGCCCTGGGGAAGG	Multiple matches in exons
CTCGCCCAAAGGCCTGGGACAGG	AT%
AGGGTGGTGGGGTGGCCCCCCGG	AT%
GGTCCTCTACCTCCAGGTCCTGG	AT%
CCAACAGGAAATCTTGCTTCGGG	Multiple matches in exons
GTGGGGTGATAGAAGGGGTCAGG	AT%
GGCTGAGAAGCAACTGCAGCAGG	AT%
GACCTACTCATAGGAGGCGCAGG	AT%
GGGTAGTGAGGTGGGGGAGGTGG	AT%
GAACCCACCAAGAATGTGAGAGG	Secondary structure or energy
CCAGCAGTCACCGAGTCACTGGG	Multiple matches in exons
GGTGCTCAATCTGGAAATTGAGG	Multiple matches in exons
GCAGGTGGCAGTGAGGGTGGTGG	AT%
GGAGTGGGGCTAGAGTGGAAGGG	AT%
ACTGCTGTTGCGATGCTCTGTGG	Secondary structure or energy
AGGAGCTCAGCCCTGGGGAGAGG	AT%
AGCACTGCGGGCCACCTTGGTGG	AT%
GTTATTTCTTCTACTTTGGCAGG	Secondary structure or energy
GCCGTAGGTCGGGGGTGGGAGGG	AT%
GGCCCCAGAGGAGCCCAGCCTGG	AT%
GTGGTTCCACCAGCTGGCGGGGG	AT%
CCGCGCATGACCGGCTTGCGTGG	Multiple matches in exons
AGAGCTGCTACTCTGGGGTGGGG	AT%
GCTATCAGGGTGGAGAACTGGGG	Secondary structure or energy
CCCCAGATGGCAAAGTATGTGGG	Multiple matches in exons
CTCCTTCCAGGTCCTGGCAGGGG	AT%
AAGAGAGGGAAAGCTCTGAAGGG	Secondary structure or energy
AGTAGCTGGAGGGCAGTGACAGG	AT%
CAGGGGCCCTGGATGTAGGACGG	AT%
CTCATGATCTCCCAGAACATCGG	Secondary structure or energy
GGGCAGGGATCTGTGCTGGGGGG	AT%
GCACGACCCCGATTCGCCCCTGG	AT%
AGTCATCCTCACCCCCTGCTGGG	AT%
CCCGGCAGCCTGTGGCCCAGTGG	Multiple matches in exons
CCCAGTCCCGATGCTTTTCATGG	Multiple matches in exons
CAGAGCTGCCTAGGCATGGTGGG	AT%
GAGGGATGTGCTGCAGCCGAGGG	AT%
GCCACCATCGAATCCGCCTGGGG	AT%
CCGGAGACTCTATGCCACGTGGG	Multiple matches in exons
CAGCCGGGACTGGAGTCCCTGGG	AT%
CAAGGGGCTGCCACTCGCCAAGG	AT%
AACTCCCTGCAGAGGCTGTGTGG	AT%
ACCCGACAAGAAGCACAAACTGG	Secondary structure or energy
CACTGGTACTCCCCTAGGCAAGG	AT%
AAGCCCCCCAGGCTCTTTGCAGG	AT%
CGCCCTCGGACCCGCCCCCGGGG	AT%
CAAATCCAACTATCGGCCCCTGG	Too close to reverse primer
GTCCAGATGGAAGGCACGGAAGG	AT%
CTCTGGCCAGCACACGACTCTGG	AT%
CAGGATCTTCATCTGGACAATGG	Secondary structure or energy
GCATAAGATGTTAGGGCAACTGG	Secondary structure or energy
ACAGCCGGGACTGGAGTCCCTGG	AT%
CCGGTACACCCTTTCTAGGAAGG	Multiple matches in exons
GCGTTGAGCTTGATACCTTGTGG	Secondary structure or energy
CCAGTGGGGCAATCTTGTGCAGG	Multiple matches in exons
CTGCAGGAGCCTCTGGATTATGG	Secondary structure or energy
GTGCAGAGCCCCTCTCTCTTGGG	AT%
GCCTTGAGGAGGCCATGGAGGGG	AT%
CCATGAAGATAAGGGGCACCAGG	Multiple matches in exons
CAGCTGCCTGTTTGCATGCCTGG	AT%
CGGCCCGGAGGGCTGGCGGGCGG	AT%
GTAGTGCCACCTCCTTACCCCGG	AT%
CCCGCTACAGCCTGGCCCGGGGG	Multiple matches in exons
ATGGTGGGGAAGAGGCTTTGGGG	Secondary structure or energy
GGTGGCGCAGCGCTCCGGGCGGG	AT%
GCTGTCCAGAGGCTCTGATCGGG	AT%
CCTCACTGACAACTTTGCTCTGG	Multiple matches in exons
CCAGGGAAGGGAGAGCTGAATGG	Multiple matches in exons
GCTCTGTGGCAGGCAGCTCCAGG	AT%
AGGGACTCCAGTCCCGGCTGTGG	AT%
GGGCTGTGTGCCTGGTAGTCCGG	AT%
GATGCCCACCTTCCGTTGGGAGG	AT%
GGAGCCATAGCAAGCTTGGCGGG	AT%
GACATTTTGCTATGGACAAAAGG	TTTT
GTCGGAGCTGCCCGAGGATCAGG	AT%
CTCTGCGTCTTTGACCCCACGGG	AT%
CCCTGCGCGGAGAGCCGGGCAGG	Multiple matches in exons
GCAGGAGATGGTCCTGTCCCAGG	AT%
CACGCCCTGGCCGCCCCGACGGG	AT%
GCCGCTGTCTAAGCAGCACCAGG	AT%
AGCGGCTGATGTCGTAGACACGG	Secondary structure or energy
CAAGCCCTGGCCAGAGCCCCAGG	AT%
AGAGGGGAGCACCGAGCGCCAGG	AT%
GGCCCTGACTCTGCAGCCAGGGG	AT%
AGTTCCCTGCGCGGAGAGCCGGG	AT%
CAGAGCTGCCAGCCATGCCCGGG	AT%
CCAGCAGCTGGATGGAGGTCAGG	Multiple matches in exons
CGGTGGTGTCCACCTACCAGGGG	AT%
GGACATACCCCCCACCCCCAAGG	AT%
CCCTGGACCACATTCCAAGGAGG	Multiple matches in exons
GCCTCACCTGAGAGGTAGCGAGG	AT%
AGGTGGCTGCCAGCTGCAGAGGG	AT%
GGCCTCTGGTGCTGGAGGGCAGG	AT%
CCGGCCATTCCCGGCTCCAGCGG	Multiple matches in exons
GGCAGACAGGCTGCCCCAGCAGG	AT%
GCAGAGAGCTGGCCTGCAGCAGG	AT%
CCGTGCCTTCCATCTGGACCTGG	Multiple matches in exons
CCTGCAGGACGCGGCTCAGATGG	Multiple matches in exons
GGACTTAAGAGGGATCATTCTGG	Secondary structure or energy
CCTTCACATAGGGGTCTGGTAGG	Multiple matches in exons
AGCACTGCCTCCTTCCCCCACGG	AT%
AAGCAGTTGAAGGAGGCTTGGGG	Secondary structure or energy
ACCGAGGCAATCTTGGGGAGCGG	AT%
GGTGGCTCAGTGGGAGAAACGGG	AT%
CCCTTCCTCCTAGGTAGGTTTGG	Multiple matches in exons
GAGGGGAGAGCTGTTGAAGCAGG	AT%
GAGCGGCCCGGGCCCCGTCGGGG	AT%
GCCCAGTTTAGCATTTCTGCTGG	Secondary structure or energy
CCCAGCTGGGCAAGGGAGTTGGG	Multiple matches in exons
ATTCAGCTCACTGAGGGCGTAGG	Secondary structure or energy
GGGCCCAGGGACTCCAGTCCCGG	AT%
CGCCTCGGCCTTCCTCTTCTGGG	AT%
CCACCTCCAGCCCACCTGCCAGG	Multiple matches in exons
CCCTTGTAGTGAGGATGCTATGG	Multiple matches in exons
GGACTGCTCCACATTGCAGGTGG	AT%
GTGAGGGCCAGAGGACACTCAGG	AT%
AGGAGGCCATGGAGGGGATGGGG	AT%
ACAGCATTCTGATTACATGCAGG	Secondary structure or energy
GAAGAAGCGCTGCAGCGCTTCGG	AT%
AGCCACTAGAGCAGGGAGGCTGG	AT%
GGATGCCCATGAGGCTCAGCAGG	AT%
CGCAGAACGCCTTGACCAGGGGG	AT%
ACTTTTGGCCCCTCATCTTATGG	TTTT
CGATCAGCTGGGCCTGTGGCAGG	AT%
CGTGGACCCTGGAACATACAAGG	Secondary structure or energy
GGTGCGCGCTCCGGGCCGCGGGG	AT%
CGCAGGCGTGACACATCCAGTGG	AT%
GAGCGCACGCGGCGGGCAGGCGG	AT%
ATGGCTGCAGCCTTGGGGGTGGG	AT%
GCTGGCTTAGAGGGTGCATATGG	Secondary structure or energy
CTCCCCAGGTGTCATCGCCCAGG	AT%
CCCAAGTATAAAAGAGCTTAGGG	Multiple matches in exons
GCTAGCTCTCCAATCAACAGGGG	Secondary structure or energy
GAGGAGGTGGCGCAGCGCTCCGG	AT%
GGAGACCCGTTCCTCTGTCTCGG	AT%
GAAGTCTGGATGGCTGCCCAGGG	AT%
GTCCGCGAAGGCTGTGAGCAGGG	AT%
GCAGCAGGGCAAGGGCTCCACGG	AT%
GCGGCGGCAGCGTGCTCCGCGGG	AT%
GACAGCCTGGAGAAGGCCAGGGG	AT%
CCTGTGGTCCCCTTTCCTGGAGG	Multiple matches in exons
AGGAGGCCCTAGAGGCACAGTGG	AT%
GCTCTGTCCAGATGGACTCCAGG	AT%
ACTCAAGGGTCCTCTCCCCAGGG	AT%
AGGGACCTGAGAGGTGGGGATGG	AT%
CTGGGCAAGGGAGTTGGGGATGG	AT%
AGGGGCCAGACTTGCCCCTCTGG	AT%
CTCCCAGCGGAAGATGGGTAGGG	AT%
ACTTCAGGGGCCCTGGATGTAGG	AT%
CCAGGGTGGAGTCTGGGCTCGGG	Multiple matches in exons
CCCGTGGGGGTCCCTTACCCAGG	Multiple matches in exons
CTGCCTCGCTGGGTGCATCAAGG	AT%
CTGCTTGCGTGGTGGGTGGGAGG	AT%
GACGAACTTACCTGGGGACAAGG	Secondary structure or energy
GGGGAGGGCTTTTGTTCTGAAGG	TTTT
GCCTGGGGGGCTTGGGTACCAGG	AT%
CCACTTCCGGGTGACATTGCTGG	Multiple matches in exons
GCCTAGGCAGCTCTGGGCCCTGG	AT%
CAATGCTGGAACGTGACATAGGG	Secondary structure or energy
CTCGGAAGTCCTCGATCAGCTGG	AT%
AGGACACCTGGAGCCAAAGCAGG	AT%
GGCCAATCTCCTTGGGGATGTGG	AT%
CAACCTGCGGTTAGTCGACTGGG	Secondary structure or energy
GTTACGTCCTGAGGCTCCCCTGG	AT%
GGGTTGGCTACTCTGGAAGAAGG	Secondary structure or energy
CTTTCGGGGTCCAGCTTTGGTGG	AT%
GCCGCCGCCGCCGAGCCGCGCGG	AT%
GTTGCTACTGGGGAATTGTGGGG	Secondary structure or energy
CCTTTATTGTAAACAGCAGGTGG	Multiple matches in exons
CTTTGCCAGGGCAGCACAGCTGG	AT%
CGTTTGGCGGAGCTGGGCGGAGG	AT%
CCCCGCCTGGGAAGCCATGTAGG	Multiple matches in exons
CGACCGGCCAGATGAGGCATTGG	AT%
CCTGCAGGCAACCTGGAAGTGGG	Multiple matches in exons
GCAGTCCCGGCGGGCACCACTGG	AT%
GCTGGGCACAGCGGCACCCAGGG	AT%
CTCAGCCTGACTCCTCTGTATGG	Secondary structure or energy
CCTCGTTCTGTTCTCCCATAAGG	Multiple matches in exons
CAGTCTTTGGCACCTCGACATGG	Secondary structure or energy
CTCTACGTGCGCCTGGGTAAGGG	AT%
GCCTATGCTCACCTATCGTGTGG	Secondary structure or energy
ATACAGCACAGAGGGACGACAGG	Secondary structure or energy
AGTGGTCCTGTGCTGCCCCAAGG	AT%
CGGTGGTCATGGAGGACTGTCGG	AT%
GACAAAAGGACAGCCTGGCCTGG	AT%
ATGTGGTTCCACCAGCTGGCGGG	AT%
ACTTCCACCCCCACAGGCCACGG	AT%
GCCACCTGGTGGTAGAATTAGGG	Secondary structure or energy
AGCTCGCCTGACTTCAGCTGTGG	AT%
GCTGTCCTTTTGTCTGTCTCAGG	TTTT
CGATGATGGAGTTGGCAGAGGGG	Secondary structure or energy
CCACCCCTGAGCTGGACTCATGG	Multiple matches in exons
GGGCAGCCATCCAGACTTCAGGG	AT%
GCCACTGAACCAGTTGTTGAAGG	Secondary structure or energy
GCTAGAGGGAACAGCCTCCTGGG	AT%
CTCCCGTTGGCAATGGGCGGGGG	AT%
CACGACCCCGATTCGCCCCTGGG	AT%
AGATGCTACGGTAAGAGTCTGGG	Secondary structure or energy
ATACTGGTGTCTATATTGGAGGG	Secondary structure or energy
AGGTGAAGTGAAACACTGGAAGG	Secondary structure or energy
GTTCAAGTGTCTTACTCTACTGG	Secondary structure or energy
CCCTCCCCCTCCCCCCAGCCTGG	Multiple matches in exons
ACCTCCTTGCCTTCTTTGTCAGG	Secondary structure or energy
GCGTAGAAGATGGGGGTCTGAGG	AT%
AGGGCTTGGGCTGGGTTGCGGGG	AT%
CAAAGAGTTTGTGACTGCTGTGG	Secondary structure or energy
GAACATGGAAATGGGGGGGAGGG	Secondary structure or energy
GGAGGCTCCGCGCGGCTCGGCGG	AT%
CTGCCCAGGGTTACGTCCTGAGG	AT%
CTTGGGGCTTAAGGCAACTTTGG	Secondary structure or energy
GGGGCGGAGCCGCAAACCCAGGG	AT%
AGCGCTGGATACTCACGTGACGG	Secondary structure or energy
GGGGTGTCAAGGTGCCAGTCAGG	AT%
CCGGCACCCCTGCCATGGTGAGG	Multiple matches in exons
CATGTACCGGGACCCGGAGGCGG	AT%
CATCAGCCACTACGCGGGTCAGG	AT%
CCAGGATTTGGCTCTGATGTTGG	Multiple matches in exons
ATCCGGGTAGACTGGCAGCATGG	AT%
CCAAAAAGGGGATCTAGGGAAGG	Multiple matches in exons
GGTGAAGAAGTTGCATACTGCGG	Secondary structure or energy
ACTTTCTCGTAGGGAAACCCTGG	Secondary structure or energy
GCAGAACGCCTTGACCAGGGGGG	AT%
GGGAAGGAGGCAGTGCTGGCTGG	AT%
GAGAGACACTGAGGGAGGCGAGG	AT%
CCTCAGCAGCCAGGAGTGTCTGG	Multiple matches in exons
CTGTCACTTTCAAACTGGCCTGG	Secondary structure or energy
CCCCCTAGGTCAGGTGATGGTGG	Multiple matches in exons
ACACAGACCCAGGGCCAGCTAGG	AT%
CAGCTGGCAGAGACCACAGGTGG	AT%
CAAACTGGTGAGGCTCTTGTTGG	Secondary structure or energy
GGGGGACTCACCCAGCCCTCAGG	AT%
CAGAAGAAAAGGACTGTCTTGGG	Secondary structure or energy
AGGGGGACCCGGGCCGCGGGAGG	AT%
GGGGGCTATGCCCACCTGGCGGG	AT%
GGGGAGCGGGGAAGTTCCGAAGG	AT%
GCTCCCCCGAGGAGCTGAGTGGG	AT%
CCCTAAGCTCTTTTATACTTGGG	Multiple matches in exons
CCTCCCTGCTCTAGTGGCTGGGG	Multiple matches in exons
ACTAGTACCTCTCCACACTGAGG	Secondary structure or energy
GCACCGGTTAGAGGAGGGTCAGG	AT%
CCTCCCGTTGGCAATGGGCGGGG	Multiple matches in exons
AGGCCACAGGGAGTGGAGAGAGG	AT%
GCTCCTTGCTCCGAGCACCTTGG	AT%
AAACGGTGTCTGCCACCCGCGGG	AT%
GAGAGGGCTGGGACCCACAGAGG	AT%
CCCCCGAGGCCGGAGCGGCCCGG	Multiple matches in exons
GGCCCAGGGTGAGGAACACCCGG	AT%
CTGTGCCTGCTCCCAAGGAGTGG	AT%
AAGGGCTTCAACTTTTCCGTGGG	TTTT
CTTAGGAAGTTAAGGGGTAGAGG	Secondary structure or energy
ACAAAACAGATAGACAGCCTGGG	Secondary structure or energy
AACTCCTCCCGACCTGCCAAGGG	AT%
GGCTCCGCGCGGCTCGGCGGCGG	AT%
CACCCCTTCCAGGGTCCTCCAGG	AT%
GATCAGCCGCAGGGACTGGGTGG	AT%
GGAGCGATTGACAGGCGGCAGGG	AT%
CTTCCTAGAAAGGGTGTACCGGG	Secondary structure or energy
CGCGCCGCCAACTCTGCCGGGGG	AT%
AGGGGCTGGATCGAGAAGGCTGG	AT%
AACCCCCGCCCATTGCCAACGGG	AT%
CTAAATGGAAGGCCTTTCTATGG	Secondary structure or energy
CAAGGCCTTGAGCTCTGGCTGGG	AT%
CCTGCTTGGCAGGGAGTCTGTGG	Multiple matches in exons
CCTGGAAGTGGTTCTTCTTCTGG	Multiple matches in exons
CCTGGGTGTCCTGATGCGGGTGG	Multiple matches in exons
AAACCAGTCTACTGCTTGCAGGG	Secondary structure or energy
CCTGCCCTATGTGGTCATGGAGG	Multiple matches in exons
AGGTAGAGGCGCGTGAGGCGCGG	AT%
GATCTGAGACTGTTGAGCAAGGG	Secondary structure or energy
GAAGGCACGGAAGGCATCCTGGG	AT%
CAGGTTGTGACGTGGCATAGTGG	Secondary structure or energy
GGAGCGATGGAGCCACAAGCTGG	AT%
GTACTCACTGGTGCTCAATCTGG	Secondary structure or energy
GAACCCGGGGAGAGCTGCAAGGG	AT%
CAGCCAACCCCAACAAGACGAGG	AT%
GGGAGCCAGTTTAGCCGGGCAGG	AT%
GGAACTCGGAGCCCTTCTCTCGG	AT%
CTCACCCTTCTGCTCTAGGTGGG	Secondary structure or energy
CGTGACACATCCAGTGGAGCAGG	AT%
GGGAATGGCCGGTGGCCCGTGGG	AT%
GGAGGGGCCCGCACCGCTGGGGG	AT%
CCCTGCTGCTGGTGGATCAGGGG	Multiple matches in exons
CAGGTGGCAGTGAGGGTGGTGGG	AT%
AGCGGTGCGGGCCCCTCCCGCGG	AT%
AGCGATTGCCGTAGAGCCAGAGG	AT%
GGACTTCCGAGCCTTGCGCCAGG	AT%
CCTAGAGGCTCTGTGGGGTAGGG	Multiple matches in exons
GCCATGCCCTAGGCCTCCTGGGG	AT%
CACTGCCTGCCCGGCTAAACTGG	AT%
AGGGGCCCTGGATGTAGGACGGG	AT%
GATGAGGCCTCAGCTCCTACAGG	AT%
CGAAGTGGACCTTCCTGACCTGG	AT%
GGCAGGTGGGCTGGAGGTGGGGG	AT%
CAGCAGCAAGCTGTGCTCCTGGG	AT%
GGCCCAGAGCTGCCTAGGCATGG	AT%
CTCTTTCCCTAGGCCCAAGCTGG	AT%
GGCTGCGGGGAGCGAGCGTGAGG	AT%
CAGCTGGCCTCTGCCTCGCTGGG	AT%
AGAGGCTCTGATCGGGACACTGG	AT%
ACTTTCCAGTTAAGGACTGAGGG	Secondary structure or energy
CTGTTGCGATGCTCTGTGGCAGG	AT%
CTTGACACCCCAAGGATGGAAGG	Secondary structure or energy
GTTGGCTGAGGCACCCTGTAAGG	AT%
CCGGGTCGATGTAAAACAGGTGG	Multiple matches in exons
GAGGTCCGAGACAGAGGAACGGG	AT%
GCCAGCTCACCAATCAGCAGGGG	AT%
GACTCAGCCCTAGACACGAAGGG	Secondary structure or energy
ACCCTCACACAGCACAGAGGGGG	AT%
CGCTGGGATGTGGAGCGGGTAGG	AT%
AGCCATCCAGCTTGGGCCTAGGG	AT%
CATGGGGCCGGGCGACCCCCGGG	AT%
GGCTAGAGGGAACAGCCTCCTGG	AT%
ACAGCTGGAGCAGGAGCTTGAGG	AT%
CCAGAAGAAGAACCACTTCCAGG	Multiple matches in exons
ACACTTGGCTCCATGTGTCTGGG	Secondary structure or energy
AAAGTGTGAGCCCAGGCCCAAGG	AT%
GGTCCTGGCAGGGGAAAGAAAGG	AT%
AGTCTGAGGCCCGTGATCCTGGG	AT%
AAGAACATAAACAAAGAGTGAGG	Secondary structure or energy
AGCCGGCACAAGGAGAGTTGTGG	AT%
CTTCTGGGTACCAAACTTGAGGG	Secondary structure or energy
GGGGAGTTCTGGCCAGAGGCAGG	AT%
GCAGCTCTCCCCGGGTTCTGAGG	AT%
GGAAAAGCCCTGTGGGGAGAAGG	AT%
GAAGAGGAGGAGGCCGCAGGTGG	AT%
CCCGGATGCCCCGTGCGCTACGG	Multiple matches in exons
CTCCACACCCCTCTAAGAAGAGG	Secondary structure or energy
GGCGGAGCTGGGCGGAGGCCGGG	AT%
CCCCCAGAACCAAGATGTCTGGG	Multiple matches in exons
CCCGAGCCCAGACTCCACCCTGG	Multiple matches in exons
AGGCTCCTGCTTTCTGGGGCTGG	AT%
AAAACGGTGTCTGCCACCCGCGG	AT%
CACCATGCCTAGGCAGCTCTGGG	AT%
CCTTCCCACTCAGCTCCTCGGGG	Multiple matches in exons
ACAGCAGCAGAAGCTCTACGGGG	Secondary structure or energy
GTGTGTGTGTGTGTGTGTGTTGG	Multiple matches in genome
GGTGACCCCAGGGGCGAATCGGG	AT%
CAGGTCCATGAGCTCCCCCGAGG	AT%
CCAAAGAGTCAGAATACACAAGG	Multiple matches in exons
GTACTAGGGGTGCCACCTTGTGG	AT%
GCCCTTCTCTCGGATCTCCATGG	AT%
CAGGCGGCAGGGCAGCTCTGGGG	AT%
CTTCCCACTCAGCTCCTCGGGGG	AT%
ATGGTGAGGCTGGACTCCAAGGG	Secondary structure or energy
CCCGGGATGCTGCTCAGTGTAGG	Multiple matches in exons
CACAGCACATGTGCCCTGAGTGG	AT%
GAAATACCTGAGATACACCAGGG	Secondary structure or energy
CCCCAAGTCCCCCAGCCAACAGG	Multiple matches in exons
GCACTGCCTCGGCAGGGGGCAGG	AT%
GGAGCAAGGAGCTCAGCCCTGGG	AT%
CTAGGCAGCTCTGGGCCCTGGGG	AT%
CTGCAACAACAACAACGGCATGG	Secondary structure or energy
GGCGTGGCGATGCCGGGTGGTGG	AT%
CCGTGGGCAACGGCTGTTGCTGG	Multiple matches in exons
ATTGCGCTGCCTCCTCTTGGTGG	AT%
ACCCCATGAGTCCAGCTCAGGGG	AT%
AGGCAGCCACATCCAGCAGCAGG	AT%
CCATGCAGAAGAATGGAGGAGGG	Multiple matches in exons
CACAGCCAGGGTGGCTGGCACGG	AT%
CGCCGGAACACCACGATCCCGGG	AT%
AAGCTGAGCAGGTGATGGTGAGG	Secondary structure or energy
CACTGAACTGGATTCGGCCCAGG	AT%
AGTGGCGGAAATTCCACCAGTGG	Secondary structure or energy
GAGAGCTTGTGCTGCGGGTCTGG	AT%
ATTGACTCTGCGTGGACTCATGG	Secondary structure or energy
GGCTGAGGCACTGCCTCGGCAGG	AT%
GGTGTCCAGGTGCGGTTGGTAGG	AT%
CCAGCCTCTCTGGGCTGCCTAGG	Multiple matches in exons
CCCTCAGCAACGGCTTCTCCTGG	Multiple matches in exons
GACAACAATGCCCAGGGGTTTGG	Secondary structure or energy
GGTGTTGTTACACTCAACAGTGG	Secondary structure or energy
AGGAAAGATCTCTCTTTGCCCGG	Too close to reverse primer
ATCGCCAGCGGTCCCAGACCAGG	AT%
CAGCACTGGGCCTGGGGAGAGGG	AT%
AGTTGAGTCTGCAGGGTAAGAGG	Secondary structure or energy
AGGACAGAGACCTGGGAGCTGGG	AT%
ACCCACAAGGCCTTGAGCTCTGG	AT%
GATTGCTGTTCGTCAGGGTGGGG	Secondary structure or energy
ACGCAATGCGGTGCTGGACGAGG	AT%
CCAGGGTGGCTGGCACGGCATGG	Multiple matches in exons
GGCAGTGCCACAGCCGGGACTGG	AT%
CCCGCGGGGGTCCAGTGACTGGG	Multiple matches in exons
GAGACCCCGAGGGCTCAGCCAGG	AT%
CCCACCCCACAACAGACTCCTGG	Multiple matches in exons
CCTCCTTGCCTTCTTTGTCAGGG	Multiple matches in exons
CCTGGGGACCCTGTAAGTGTGGG	Multiple matches in exons
CTGTCTATAAGAAATCCATATGG	Secondary structure or energy
GTCCCTGATGGCTCAGTCCTGGG	AT%
CCAGCTGGGCAAGGGAGTTGGGG	Multiple matches in exons
CCTGAGGGTGAGTTACAGGGAGG	Multiple matches in exons
CACCAAGTCTGAAGCAGATTTGG	Secondary structure or energy
GTGGCCCAGCAGTTCGTGATGGG	AT%
CTGGGGCTCTGGCCAGGGCTTGG	AT%
AGTGCTTCCTCTTCTTAGAGGGG	Secondary structure or energy
CCTCCACTGTCCTTGACCCCAGG	Multiple matches in exons
CCCTTCCGATCTGCGGGCCAAGG	Multiple matches in exons
GGGACACCAGCACCCCCTTGTGG	AT%
CGTGCCCGTTCCCTGCCACCCGG	AT%
ATTCTGACTCTTTGGAAACCAGG	Secondary structure or energy
AATCATATTTTTGTGGGAATGGG	TTTT
CATGTAAGTGAAGAAGATGCGGG	Secondary structure or energy
CCTGCTCTGTCCAGGGCAGCTGG	Multiple matches in exons
GCTCTGCAGCTGCGCAAAGTCGG	AT%
GCCAGAGTCCTGGGGGTAGAAGG	AT%
AGCGCTAACTGATGAATTCCGGG	Secondary structure or energy
CTACGCGGGTCAGGATGCCACGG	AT%
GCCTACATGGCTTCCCAGGCGGG	AT%
CTTCCCCAGGGCGAAGAAGAGGG	AT%
ATCCTGGAGGACCCTGGAAGGGG	AT%
ACAGCGGCAATGGGCGGTGTCGG	AT%
GAATGGCACGTGGAGTGCAGAGG	AT%
ACTGTACCGGGAGCCCAGCCGGG	AT%
CGTGGATGATGCGGCCAGGTGGG	AT%
CTGTGTGGCACGCCTGGCTGTGG	AT%
AGCCAGGTTTTAAGAGGTCTGGG	TTTT
CGACGGCTCCCTCGCCCACTAGG	AT%
CAATCACCAAGATGGCTGCAAGG	Too close to reverse primer
AGGCCATGCACACGGTGAGTAGG	AT%
AAGGGGGTGCTGGTGTCCCAGGG	AT%
CGCTCCCAGGGGGGCTCAGATGG	AT%
GATCCCTCCAGAGGCCCGCCAGG	AT%
ATGGGCGGTGTCGGGGAGCCCGG	AT%
CGGGGGCACATCAGGTGCTGAGG	AT%
CTCTTCCTCCTGCTCTGGGTTGG	AT%
ATTAGACTGCCCCAGTGGTAGGG	Secondary structure or energy
GTGCGGTTGGTAGGAGACCAGGG	AT%
CGCTGGGCACAGCGGCACCCAGG	AT%
CCCCACCAAGCAGGATGACCTGG	Multiple matches in exons
CATGTGGTTCCACCAGCTGGCGG	AT%
CAGGACAGGTAGATCTGGGGAGG	AT%
GCTTTTGCCACGGTCCAGGCTGG	AT%
AGGGTGTGAAATCTGATTTAAGG	Secondary structure or energy
CAAAACAGATAGACAGCCTGGGG	Secondary structure or energy
GAGGTTTTCTCTTCCCAGACAGG	TTTT
ATCAACCCCTGGCCTTCTCCAGG	AT%
CTCCCTTCCCTGGGATTAGGTGG	AT%
GGCGGGAAGAAACTCCCACGTGG	AT%
ACTTAGTTGTTACATTGTTTAGG	Secondary structure or energy
CGAGGTCTAGGATGTGCAGCCGG	AT%
AGACACAACACAAATACACAGGG	Secondary structure or energy
GACGTTCTGTGTGGCACGCCTGG	AT%
GTCTTCAGCTGCCTGGCGCAAGG	AT%
GCGGCTCGGTGCAGCCCGCGCGG	AT%
GCACTTGAGGGTCGGGTACTGGG	AT%
AGGGGCCCCGAAGGGAGGTGGGG	AT%
GGAGGGAGCCGGCGACGAAGGGG	AT%
GCAGGCGCACGCTCTTACGGCGG	AT%
AGGAGTCTGTTGTGGGGTGGGGG	AT%
AAGGAAGGCTTTGTTGGTAGGGG	Secondary structure or energy
GGGGCTGGCCCCGTGGCCTGTGG	AT%
GGCCTGCTCCCTGAACCTGGTGG	AT%
GATGGAGGTGGCGGTCGCAGTGG	AT%
GGGCAGCTCTTATCCAGGGTAGG	AT%
GCCCCGCTACAGCCTGGCCCGGG	AT%
GCCTGCCCGGCTCTCCGCGCAGG	AT%
AGGCAATCTTGGGGAGCGGAGGG	AT%
GCCCTCCAGCACCAGAGGCCAGG	AT%
GATCTGTGCTGGGGGGTTGGGGG	AT%
GCAAGGAGCCAGAACCCAAGGGG	AT%
GCCTCACCCTTGGTTGTAGGTGG	AT%
GGGGCTCTGGCAGGGTGTGGAGG	AT%
ATCTCCCACCTAGAGCAGAAGGG	Secondary structure or energy
GTGCTGGAGAATTACAACAAAGG	Secondary structure or energy
GGGTCCAGCCAGGTTTTAAGAGG	TTTT
GAGGTGGGGGCGGGTGCTCCAGG	AT%
CCGAATAGTGTCCGATGACACGG	Multiple matches in exons
GTGGGAGCTCACTTTGGGCTTGG	AT%
CCTCTCCACCCTGGGTGCTCTGG	Multiple matches in exons
GAGGGCACAGGCTGCAGGAGAGG	AT%
GCTTCTGAATCTCCTCCCAACGG	Secondary structure or energy
GAATTGGGCAGGGCTTGGGCTGG	AT%
CATGAGTCCAGCTCAGGGGTGGG	AT%
CCTTCTCGATCCAGCCCCTTGGG	Multiple matches in exons
GGGTACCTAACAACCACTCAGGG	Secondary structure or energy
CTCCAGTACTGCATGGAGGCTGG	AT%
GGGGAAGAGGCTGGAAAGGCAGG	AT%
CTCTTTGCCCTAGCCGCCTATGG	AT%
AATGAAGGCAGCACCCTTATGGG	Secondary structure or energy
CTGAGGAGCCCGGAGGGAGCCGG	AT%
CGCCCGGAGGCCGTAGCGCACGG	AT%
AGCACTGGGCCTGGGGAGAGGGG	AT%
ACTGCCCCATCACGAACTGCTGG	AT%
CCAATAAGGTGAGGCTGTGCAGG	Multiple matches in exons
CCAGTGGGCTATGATGGATAAGG	Multiple matches in exons
GAAGATGCCACTGTGCCTCTAGG	Secondary structure or energy
CTGAGCTGGACTCATGGGGTGGG	AT%
CAATAAGGTGAGTGCAGGCGGGG	Secondary structure or energy
GCGCGTTTGGCGGAGCTGGGCGG	AT%
ACAGTGGCGGATCATCGTGGGGG	AT%
ATGGGCAGGGATCTGTGCTGGGG	AT%
GTGGTATATTTTCTATTTTGTGG	TTTT
GCCCGTAGCTGGAGGTTGTCTGG	AT%
ATTGGGAGGGCCTACCTGGGTGG	AT%
AACTGCCCAGAGGTCAGCCCAGG	AT%
GTGTGTGTGTGTGTTGGGGGTGG	AT%
CTCAGGTGCTTGTGCACACTAGG	Secondary structure or energy
GAAAGGCCTGTGAGGGCGGCTGG	AT%
ACTGACCAGCTGATTTTTGTGGG	TTTT
CTTCCATTTAGAGCTCAGGATGG	Secondary structure or energy
GAGTGCTTCCTCTTCTTAGAGGG	Secondary structure or energy
CAGAGGGAGGAGGCTCCGCGCGG	AT%
ACCATCCGCATGATGGAGAATGG	Secondary structure or energy
AGCTGCTGGTCCCAGATGTGGGG	AT%
CTGGGGCTGAAAGGCTTCCTGGG	AT%
ATGGAGGTCAGGGATGGCGCTGG	AT%
CCTTGTGTATTCTGACTCTTTGG	Multiple matches in exons
AGGTTTCCGTCGGCAGCTTCTGG	AT%
CCACCTGGCGGGCCTCTGGAGGG	Multiple matches in exons
GCTGGGAGAGCTTGTGCTGCGGG	AT%
GCTCAGGGGCTTTCAGGTGCGGG	AT%
AAGGGTGTACCGGGAGGACGTGG	AT%
ATGAATCAACAGAGTTTCAAAGG	Secondary structure or energy
GACTTGGTGAGCTGCCTGGTGGG	AT%
GTTTTCCTTTGTCCCTTCCCTGG	TTTT
CTCCCGGCACACAGGCAGGCCGG	AT%
AATGGGGGGGAGGGACTTGAGGG	AT%
AAACCCAAGTTTGGTGAGAGAGG	Secondary structure or energy
GCATGGGGCCGGGCGACCCCCGG	AT%
CGAGGACAAAGGCTGTGACGAGG	AT%
CCAGCCCTCCGGGCCGCCCGCGG	Multiple matches in exons
CTCCTCGCAGGACTTGCTGTGGG	AT%
GGAAGATGAGCTCGGGAGTGAGG	AT%
GCGCAAGGAGCCAGAACCCAAGG	AT%
GAGGCTCAGGTGCCCAATCCTGG	AT%
CCTACCAAGCTGTCCCTCCTGGG	Multiple matches in exons
GTCATCGGCAAGGTAGGACTGGG	Secondary structure or energy
ATCAATTGAATTGAGGTTTTGGG	TTTT
GCGCTGCAATCGCTGCAGATGGG	AT%
AGCTGGACCCGAGGCTGACTTGG	AT%
AATGTTGATAGACTGGTTCAGGG	Secondary structure or energy
GCCCGGCAATAGTGCAGCACAGG	AT%
GCTGAACCAGTGGGGCTGACGGG	AT%
AGAGGTCCCGTTGCAGGACAGGG	AT%
GCAGACACCAGCACTGGGCCTGG	AT%
AGGTCGGCAGAGGCCACAAGAGG	AT%
AGGTGGGGGTCCCTGGGCGAGGG	AT%
CTCAGTGCTGTAGGCATGCTAGG	Secondary structure or energy
AGAGGGGTGTGGAGGGAGTCTGG	AT%
AGCAGGTCCAGCCAGAGCTTCGG	AT%
GGAACCTCTGGCCAGTCCTGTGG	AT%
CTACACAGTCTGTTTCAAACAGG	Secondary structure or energy
CCATTCAGCTCTCCCTTCCCTGG	Multiple matches in exons
GGCGGCTGTGCCTGCTCCCAAGG	AT%
GGGATAGCAGAGAGGCCCACAGG	AT%
GTCTTTGCTTTCTTCTTAGCAGG	Secondary structure or energy
ATGCCGCTGCTGGGGCTGAAAGG	AT%
CGTTGCAGGACAGGGTAGTGAGG	AT%
CAATGTCTCCTTCCAGGTCCTGG	Too close to reverse primer
GTGCCCTGGGGCTCTGGCCAGGG	AT%
GATGATTTCTTCAAGGTGACAGG	Secondary structure or energy
CTGAACTGGAACGGAGGGGGTGG	AT%
GGTGGGGGTCCCTGGGCGAGGGG	AT%
CCCCTTATCTTCATGGGTCCTGG	Multiple matches in exons
GGGCAAGGGGTGGGGATCGGGGG	AT%
CTCCTATTATTGCTTGGATCTGG	Secondary structure or energy
CCAGAGCCCCTTCCATCCTTGGG	Multiple matches in exons
GAAGGCGAGCCAGGAAGCCAGGG	AT%
GCACATGTCCAACAGGACCAGGG	Secondary structure or energy
CAGTGCCAGCTCTCCCCGGGGGG	AT%
ACAGCGTCGTATCCACCTAGAGG	Secondary structure or energy
AACCCCAGAGTGAGTGGCAGGGG	AT%
ACTTTTGTGACCTGCTCAGGGGG	TTTT
CCACTGGTGTCAGCGCAAACTGG	Multiple matches in exons
CTGCCTGACCCTAGAAGGGTGGG	AT%
CAATGATCAGCCGCAGGGACTGG	AT%
GTCAAGGCCACAGGGAAGGTAGG	AT%
CACGTGGCATAGAGTCTCCGGGG	AT%
CCGCGGGCGGCCCGGAGGGCTGG	Multiple matches in exons
ATTGCCAACGGGAGGGGCCGGGG	AT%
GAGCCTCAGGACGTAACCCTGGG	AT%
ACTGCACAATGGGCGCCTGGGGG	AT%
CTTCGTCGCCGGCTCCCTCCGGG	AT%
CCCCAGCCTGGGGAAAGGGCTGG	Multiple matches in exons
GGAGGGGATGGGGCTCTGGCAGG	AT%
GGGTGCCGTAGGTCGGGGGTGGG	AT%
GAGCTCACTCCCTATCGCCCTGG	AT%
CCAGACTCGGGGCGTGGGCGCGG	Multiple matches in exons
GCCGCAGCTTGGCCAGCTTGTGG	AT%
CCAAGCCCCCACCCCTGAGCTGG	Multiple matches in exons
ATCTGGACAGAGCCAGCCTGAGG	AT%
ACGCCTCGGCCTTCCTCTTCTGG	AT%
GCAGGCGGCTCTGAGGAGCCCGG	AT%
CCAGGGCACCGCTGATGTCATGG	Multiple matches in exons
CAAAGAGCTCCTCATCTCCTTGG	Secondary structure or energy
CCCAGCCCTTTCCCCAGGCTGGG	Multiple matches in exons
AGGAGGTAGGGACAAGGTCCTGG	AT%
ACCTCCTTACCCCGGGTGGCAGG	AT%
GATCCTGCAAAGAGCCTGGGGGG	AT%
CCCAGTGACTCGGTGACTGCTGG	Multiple matches in exons
GCGGAAATTCCACCAGTGGGCGG	AT%
CCTCAAGGCCCACTGTCACCTGG	Multiple matches in exons
GGTTGGTAAAAGATATGTTCCGG	Secondary structure or energy
CCCCGATGTCCATGGCTTTGAGG	Multiple matches in exons
CTGGGGAGGGTGCACCTGGCGGG	AT%
CAGGAAAGGAGCCTCACCCTTGG	AT%
GCCAAGTCCTGCAGAGGGAATGG	AT%
CCAACATCAGAGCCAAATCCTGG	Multiple matches in exons
CATGGGCAGGGATCTGTGCTGGG	AT%
GGCTCAGCAGTGGGAAGGAAAGG	AT%
GCTCTCCCTTCCCTGGGATTAGG	AT%
CCTGATGGAGCCACCCTCATAGG	Multiple matches in exons
AAATCCTGAAGCTACCCCCATGG	Secondary structure or energy
GAAGCAGCTGTGGGGAATGGAGG	AT%
CTGGGCTCGGGCAATGCTGAGGG	AT%
CCATCCCAGCTCCACAATGATGG	Multiple matches in exons
AGAGGGGCCCCGAAGGGAGGTGG	AT%
CTGCTTCTGTCCGTAGGCCCTGG	AT%
ACCAGCTGAAAGCCTGAGTGGGG	Secondary structure or energy
AGATAAGAAAACCGCGTTAGAGG	Secondary structure or energy
CGTCATCGGCAAGGTAGGACTGG	AT%
CCCCGCTTCCTCTGCTTGCGTGG	Multiple matches in exons
ACCAGCAGGACATCGCGGGTAGG	AT%
GGTTGTGACGTGGCATAGTGGGG	Secondary structure or energy
CACTGCACAATGGGCGCCTGGGG	AT%
CATGACCTTCACGGTGAGTGTGG	Secondary structure or energy
GCGCAGCTCCTCGATCTCCTCGG	AT%
AGACAAAAATCTTCAATCAGAGG	Secondary structure or energy
CCAGACTCGCCCCCAGACTCAGG	Multiple matches in exons
GAGGCCTAGGGCATGGCCCCAGG	AT%
ATGGGTAGGGGCGCCCCCAGCGG	AT%
GGAGACGCTGGGATGTGGAGCGG	AT%
CCCTCCTGCCTTGACCCCCTAGG	Multiple matches in exons
GGGGATTGACCCCAGGGCAAAGG	AT%
GCTCATCCCCTCCACAGGATTGG	AT%
GGTCAATCTTCCCCCTGAGCAGG	AT%
CCTGGGCAGGGAGTTGTGCCAGG	Multiple matches in exons
CTGGAGCCGGGAATGGCCGGTGG	AT%
AGATGCCAACCCAGAGCAGGAGG	AT%
ACGAGAGGATGAACCAGGCAAGG	Secondary structure or energy
AGGAGGTGGCGCAGCGCTCCGGG	AT%
CCCAGTCACTGGACCCCCGCGGG	Multiple matches in exons
CAGGGGATGGTCCGCTCCCAGGG	AT%
GGTCGTCCACGGCAACGTGAAGG	AT%
AGAAGCAGTCCAGGGGCTTGAGG	AT%
ATCCCTACCCCTGACAAAGAAGG	Secondary structure or energy
GGTGCTAGCCGAAAGGGCGATGG	AT%
ACGGTGGGCACGCCAGACTCGGG	AT%
GCTGCTTTCTGCCGCGGCTCTGG	AT%
CTCAGGTATGGATGTTTTGGGGG	TTTT
GGTAGGCGACACAGGCCGTCGGG	AT%
GACAGCCGGGTTCACTGGGCTGG	AT%
CTTGTGGAAGATGTTGGGCTTGG	Secondary structure or energy
GGCCAGGGCGTGGCGATGCCGGG	AT%
GAGTGGGGTGCTAGCCGAAAGGG	AT%
CACTGCCTCGGCAGGGGGCAGGG	AT%
GTGGGAGTGAGGGTGGGGGTGGG	AT%
CTGAAGTTGCCAGGAAGTCTGGG	Secondary structure or energy
ACATTCCATTGGAAGGAAATAGG	Secondary structure or energy
CAAAGAGAACTGAAGACAAAAGG	Secondary structure or energy
CCTGCACAAGATTGCCCCACTGG	Multiple matches in exons
GAAGTCTGGCGACATCTGGCTGG	AT%
CCAAACCTACCTAGGAGGAAGGG	Multiple matches in exons
GCCAACCTGCCTGAGCCTAAAGG	AT%
GCCAGCTGCAGGGTCAGGAGAGG	AT%
GCGGGAGGGGCCCGCACCGCTGG	AT%
CAATCTGAACTGGAACGGAGGGG	Secondary structure or energy
AAAAGCAGTTGAAGGAGGCTTGG	Secondary structure or energy
ATTCACCTGCTGAGGGGAGTAGG	Secondary structure or energy
CCACGCAAGCCGGTCATGCGCGG	Multiple matches in exons
GCCCCAGGGCACAGGAGTGAAGG	AT%
ATCCAGGCCACCTCAGCTGTGGG	AT%
CCCCTCCCTGGCTGAGCCCTCGG	Multiple matches in exons
AGCGCTTTCTGTGGGAGACGGGG	AT%
CACTTTTGTGACCTGCTCAGGGG	TTTT
GGACAGCCTCTGAAGGGCTGAGG	AT%
AACCACATCCCCAAGGAGATTGG	Secondary structure or energy
GTCTGTGGTGCTCTTCGGCTTGG	AT%
CAGGTCTCGCCCAAAGGCCTGGG	AT%
ACAAACCTGCAGAGGGGTACAGG	Secondary structure or energy
GAAGGGACTCTGCGAGGTTGTGG	AT%
CTAAGCACTGCAATCTGGGAAGG	Too close to reverse primer
CCCTCATAGGGCTGAACCAGTGG	Multiple matches in exons
GGGATCTGTGCTGGGGGGTTGGG	AT%
GTGCCCGTTCCCTGCCACCCGGG	AT%
CCGTGTCTGCCTCTGGCTGCTGG	Multiple matches in exons
GCGGCTGAGTAAGAGCCGCCAGG	AT%
GGGACCTGAGAGGTGGGGATGGG	AT%
GGGTGTCAAGGTGCCAGTCAGGG	AT%
GAAGGCAGGGAGAGTGAAGGTGG	AT%
GGCTAAACTGGCTCCCTGCATGG	AT%
CAAAGGCCCCCTATGCCCCAGGG	AT%
GGATGGCTGCAACATGACTATGG	Secondary structure or energy
CAGGCCAGCAATGATGTCGGAGG	AT%
AGAAGGGACGACAGCTTCTTTGG	Secondary structure or energy
GGTGGGGGAGTCACAGAGTCAGG	AT%
CGTTGCTGCCGCCACAGGAATGG	AT%
AAGTGTTCCTCTGTTGCACCCGG	Secondary structure or energy
GAGGACTGAGGAAAGCCAGCAGG	AT%
GCAGGTGGCTGCCAGCTGCAGGG	Multiple matches in genome
CCCGCGCGACAGTCCCGGCTGGG	Multiple matches in exons
ATGAACTCTCCTCAAGACGAGGG	Secondary structure or energy
AATGTATACATGTGCGAGTGTGG	Secondary structure or energy
GCTGGCCCCGTGGCCTGTGGGGG	AT%
CCTTCCAGAAGGTCTGCATCTGG	Multiple matches in exons
CAGCACCAGAGGCCAGGGAAGGG	AT%
CTCCTTCCCACTCAGCTCCTCGG	AT%
GGTGTGACCGTGTCTGCCTCTGG	AT%
AGTGGGCCTTGAGGAGGCCATGG	AT%
GATGAGGCATTGGTCGTCCACGG	Secondary structure or energy
AGGTGGCAGTGAGGGTGGTGGGG	AT%
GCTTGTTGAAGTCGAGCGCCAGG	AT%
GCGCTCTGAAGAGGACCTGGTGG	AT%
GATTGGTGAGCTGGCCCCAGAGG	AT%
GGCGGTCGCAGTGGCCGCGGCGG	AT%
GAAGTCCAGGTCCAGATGGAAGG	Secondary structure or energy
GGGCTCCAAGCTGCTTGAGGGGG	AT%
AAGGGAGGTAACCAGGGAGAGGG	Secondary structure or energy
GCATGATGACCCACCTGTCTGGG	Secondary structure or energy
CCCCTCCCGTTGGCAATGGGCGG	Multiple matches in exons
CCATCATGCAGTAGAGGTCCTGG	Multiple matches in exons
GTGGGCAGAGGTGGGCCCGTGGG	AT%
GGCAGGGTCCATGTCCTGCTTGG	AT%
AGCTGAGATGCCCCAGGATTTGG	Secondary structure or energy
ACAACCTGCGCACCGACCGGTGG	AT%
CCAGGAAGCCAGGGAGTGGCAGG	Multiple matches in exons
GGCCTGTCCTCCCAGGGAGCTGG	AT%
ACCCAAGAATTGCGTGTGCCAGG	Secondary structure or energy
CCGGGGGGCCACCGTGTCATCGG	Multiple matches in exons
GAAAGGTCTCATTCCAGTGCGGG	Too close to reverse primer
GTGCTCCTTGGCCCGCAGATCGG	AT%
GAGCATGAAAGTGGACATACAGG	Secondary structure or energy
CTTACCTCCGGCCCGCCGCAGGG	AT%
CACAGTATGGCTGCAGCCTTGGG	Secondary structure or energy
CAGATTGCGCTGCCTCCTCTTGG	AT%
AGCCGAAGAGCACCACAGACAGG	AT%
GGGAAAGGCCAATCCTGTGGAGG	AT%
GCTGCTGGGTGTGTGTCTGGAGG	AT%
GGCGTGGAAGGCATCCTGAAGGG	AT%
ATGGTGAGGGGAGACCCCGAGGG	AT%
GCAGCGCTCCGGGCGGGAGAAGG	AT%
AATAAAGGCAGATGTGTGACAGG	Too close to reverse primer
AGGCTGGGCATAAGATGTTAGGG	Secondary structure or energy
ACCCAGCCCTTTCCCCAGGCTGG	AT%
CTACCACAACTCAGAAGGGAAGG	Secondary structure or energy
GGAATGATCAAGCAGGAACCTGG	Secondary structure or energy
CCAGGGCTCTGGGGCCCACCAGG	Multiple matches in exons
GGATGGGAGTGGTGCCCTGTTGG	AT%
GCACCCCCTCTTCTTCGCCCTGG	AT%
CAGCTCTGTGCGTGAGCTGAGGG	AT%
CTCACTTCATCTGCAGGGTCAGG	Secondary structure or energy
GTCAGTGAGGCCTGAAAGCAAGG	Secondary structure or energy
CGGCTGAGTAAGAGCCGCCAGGG	AT%
AGGAGACAAGGGCACAAGGGTGG	AT%
GCAGGTAGACCAGGAAGAAGAGG	Secondary structure or energy
GGGTCCGACTGGGGAGGAAAAGG	AT%
CCCAGACCCAGAAAGGAGCTAGG	Multiple matches in exons
CCTCAGGGCTAGCTCTCCCAAGG	Multiple matches in exons
GGCAGAGTTGGCGGCGCGCGAGG	AT%
GGCCACCATCACCTGACCTAGGG	AT%
CTTCCCACCTACCCCTACCTGGG	AT%
GTGGCATTCCACATCAACAAGGG	Secondary structure or energy
AGCAAGGCTGGGGGTCCGACTGG	AT%
CCCCTCTCTCTTGGGGCAGGAGG	Multiple matches in exons
CCTCGATGCTCTTATGTTTCTGG	Multiple matches in exons
CTCTGCACCACTTTCTCGTAGGG	Secondary structure or energy
AGTGTTTGGTTCCACGGCCCTGG	AT%
AGAAGTACCACAGTCAGGTGAGG	Too close to reverse primer
GCGTGGAAGGCATCCTGAAGGGG	AT%
CTCCCCCCAGCCTGGGGAAAGGG	AT%
AAGGTGGAGGTGTCGGGGCAAGG	AT%
CTAATGTTCTCTCTGGAACCTGG	Secondary structure or energy
GCAGGTGTAAAGTTGGCAGCGGG	Secondary structure or energy
GCCAGGGTGGAGTCTGGGCTCGG	AT%
CCAGGACCTCTACTGCATGATGG	Multiple matches in exons
GAGCTGCCCCTTCCTAGAAAGGG	Secondary structure or energy
GAGGAGTTTAAGCCCCGCCTGGG	AT%
ATGGGGGTGCAGGTGCCTCAGGG	AT%
CAGGCACCATCATGCAGTAGAGG	Secondary structure or energy
GCAGGGGTGGCTTTGGTAACAGG	AT%
CAAGAAAGCACCAAAGACCAAGG	Secondary structure or energy
AATGATCAGCCGCAGGGACTGGG	Secondary structure or energy
CCACCATCGAATCCGCCTGGGGG	Multiple matches in exons
GCAGGCTCAGGAGGCTGGGATGG	AT%
GGCCGGTGGCCCGTGGGGGAAGG	AT%
CTGTCCTGCAGGAGGCCTGGAGG	AT%
GGGGTGTGGAGGGAGTCTGGCGG	AT%
AACTTTACACCTGCTGGTGCAGG	Too close to reverse primer
GAGACGCTGGGATGTGGAGCGGG	AT%
CCCGCCCTCGGACCCGCCCCCGG	Multiple matches in exons
GCGGTGGTGGTGGGCCTGGCAGG	AT%
GCCTCTACCCTGGACTTCTCTGG	AT%
AACACCGACGGTCCCTCTCCTGG	AT%
AGCCTGGGTGGAGGGGTGGGGGG	AT%
GGGCTGGACACAGTGGGAGTTGG	AT%
GTGGGCGGAAAAGCCCTGTGGGG	AT%
AGACACCAGCACTGGGCCTGGGG	AT%
CACCCGGCATCGCCACGCCCTGG	AT%
GGGGAAGCAACAGCTGGGATTGG	AT%
CCATATGTGAAGATGAGTTCGGG	Multiple matches in exons
GCCCCCCAGGAAGGGCTTAGGGG	AT%
GCTGAGCCTGCGCTCTGAAGAGG	AT%
CAGGACAAAGGCCAGGACTGTGG	AT%
GGCCTCAGGCCTGCCTGTGCCGG	AT%
GGGGACTCAGGGGCTGTCCCAGG	AT%
GAGGCCTCATCACCAGCTGTGGG	AT%
CGCATCAGGACACCCAGGTAGGG	AT%
AAGCTGGAGCGCCTGCCCGACGG	AT%
GGCGGGCAGGCGGGCCATGGAGG	AT%
ACCCTCTGTCCCCCACATCTGGG	AT%
AGCCATGGGGTGTCGGTGCTGGG	AT%
CTGCTGGGTGTGTGTCTGGAGGG	AT%
GAGGGGCCCCGAAGGGAGGTGGG	AT%
CCGCCCGCGCTGTTGCGCATGGG	Multiple matches in exons
GCCCAGCTGGGTGTAACCCCAGG	AT%
GACTCTGCGTGGACTCATGGGGG	AT%
GCTGGGGCTGAAAGGCTTCCTGG	AT%
GGATGGACACCTCCCCAATGGGG	AT%
AGAGGCCAGGGAAGGGACAAAGG	AT%
CCTCCTGGGGGAGTCATCTGTGG	Multiple matches in exons
CCCACCTCTGCCCACTGGCCTGG	Multiple matches in exons
GCCAAGGCACAACTACCGGAGGG	AT%
GAGAGTACCATGCCCTGGCGGGG	AT%
CAGGTGCCTCAGGGTCTCCGTGG	AT%
AGCGCGACGAACCCATTCCGCGG	AT%
ACCTACCCGCGATGTCCTGCTGG	AT%
CCCCTCCCACCCCCGACCTACGG	Multiple matches in exons
CTACTCTGACTCTGGATGTCAGG	Too close to reverse primer
AAGTGGAGAGGAAGGGGAGAGGG	Secondary structure or energy
CGCGTAGTGGCTGATGACCCGGG	AT%
AAGGGGATCTAGGGAAGGGGTGG	AT%
CACTCCTGTGACCTCACCCCTGG	AT%
GAACATGCCCATCAGGTGGCTGG	AT%
AGCCGCGTCCTGCAGGAGCTGGG	AT%
AGCCAGGTGAGGGGAGGCAGAGG	AT%
AGCAAAGAGGGCTGTGTGCCTGG	AT%
GGGCTCCGAGTTCCTAAAGGAGG	AT%
GAGGTGCGCGCTCCGGGCCGCGG	AT%
GAGGCAATCTTGGGGAGCGGAGG	AT%
CCACTTAAAGGTAGGTGTTGGGG	Multiple matches in exons
GGCAGCCATCCAGACTTCAGGGG	AT%
CAGCCTTCACTGTGACACGGGGG	AT%
CCCAGGCTGGGGGGAGGGGGAGG	Multiple matches in exons
GACAGGTTTATTTTCCCCTTCGG	TTTT
CCAACCGCACCTGGACACCCTGG	Multiple matches in exons
GTTACACTGGAGCCTGCTGCAGG	AT%
GTCCTGCGCCTCCTATGAGTAGG	AT%
CCTCGGGCAGCTCCGACTTGGGG	Multiple matches in exons
CAGGGAGTGGAGAGAGGGTGGGG	AT%
AGGGAAGCAGCTGTGGGGAATGG	AT%
CCCCGCCCATTGCCAACGGGAGG	Multiple matches in exons
GACTCCCCCAGGAGGAAGACAGG	AT%
GGCAGAGGGGTTGTAGCAGAGGG	AT%
GATGCTGGTGGTTGTAGGGCAGG	AT%
CTAAGAAGAAAGCAAAGACTGGG	Secondary structure or energy
ACAGGTGCGACAGTCACATCTGG	Secondary structure or energy
AAACTCGGAGCGCACGAAGCGGG	AT%
AACCCTGACCAGAGGTGAGCAGG	AT%
CCTCTGCAGCCCCTTTCCTCAGG	Multiple matches in exons
CTGGGTGCTCTGGGTCATGGAGG	AT%
GACCAGAAGGAAGACCCAGGAGG	AT%
AGGGCCCTGACTCTGCAGCCAGG	AT%
CCATCATTGTGGAGCTGGGATGG	Multiple matches in exons
CCGCCCAGTCGACTAACCGCAGG	Multiple matches in exons
CCAAACGCGCTACTTTACTTGGG	Multiple matches in exons
GCATGTCATCGGCTCAGCAGTGG	AT%
GCCGGGCGACCCCCGGGGGCGGG	AT%
ATCGCGGGTAGGTGCCCCTGAGG	AT%
GAGGGACTTGAGGGTGAGGAGGG	AT%
AAGCACTTATCCTCAGGATAGGG	Secondary structure or energy
CCTGGTGCCCCTTATCTTCATGG	Multiple matches in exons
CATGTCCAACAGGACCAGGGTGG	AT%
ACCTGCTGGTGCAGGTTGCTCGG	AT%
CAGTGGGAACACAGTTATGTGGG	Secondary structure or energy
GCTCCCCTAGTTCGCGAGCCTGG	AT%
ACAGGTTCCTGGAAAGCAACTGG	Secondary structure or energy
GGCCCAGCAACTCCAGTGTAAGG	AT%
AACCTTCGCTCTTCATTGACTGG	Secondary structure or energy
CTTCCACCAAGGCATCCGAGGGG	AT%
GCTTGGCTTCTTCCCCCAGGAGG	AT%
GGAGAGTGCAGGCAGTACAGAGG	AT%
CCACTGGGCCACAGGCTGCCGGG	Multiple matches in exons
GGGCCACATCTCCAGGACTCTGG	AT%
GGCAGGTTAGGAGGAGCAGGAGG	AT%
ACGCTATCGTGGGCATCGTCTGG	AT%
CACTTCCTGGGAGGAGGCCCAGG	AT%
AGGACAGGGTAGTGAGGTGGGGG	AT%
CCTAGGCTGAGGTAGGGATGCGG	Multiple matches in exons
AAGTCGCCCAGCTCCCTGGGAGG	AT%
CACGGCATGGGGCACTGGACAGG	AT%
GGGAGCGGGGAAGTTCCGAAGGG	AT%
CCAACTACCAATCCATCAAATGG	Multiple matches in exons
GACGTGGCATAGTGGGGAAGAGG	AT%
GCGGAGGGCCAACTGCAAGAAGG	AT%
AGGACAACTAAATACATGACTGG	Secondary structure or energy
CGCCTGGTAGGTCATGCTGGCGG	AT%
ACTATGCTAAAACTGTTTCTTGG	Secondary structure or energy
GGAGACCAGGGGCCGATAGTTGG	AT%
GGGAAAAGCAGGGGTGGCTTTGG	AT%
CCTCTGTTGCACCCGGACAAAGG	Multiple matches in exons
AGTGTCCACCACCCTTTGAATGG	Secondary structure or energy
GGTTCTCCTCGGGAATGGCCGGG	AT%
GGGCCGCCCGCCAGCCCTCCGGG	AT%
GGTCTCTCTCAGGCACGTGAAGG	AT%
CCCCGAGCCCAGTTCCCAGTGGG	Multiple matches in exons
GGGTTCTCCTCGGGAATGGCCGG	AT%
CCAGGCTGGGGGGAGGGGGAGGG	Multiple matches in exons
GGGAGAGCTCAAGAGCCAGATGG	AT%
AAGTATGAGCCCATCTCACTGGG	Secondary structure or energy
GCTATATACAGCCTAAAGCAAGG	Secondary structure or energy
CAGCCCTTTCCCCAGGCTGGGGG	AT%
CAAGCGGCTCAATGCGCACACGG	AT%
GGCCCGGGCCCCCTTACCTCCGG	AT%
ACCTCAGAGCTTGCTGCAGAGGG	Secondary structure or energy
CTGCTACATCATTTTGTGATTGG	TTTT
CTCCTTCCCCCACGGGCCACCGG	AT%
CATCGGCCACCACGGTGCGGAGG	AT%
GACCACGGCCGAGGCTACCTGGG	AT%
GCAACCTGGAAGTGGGGGTAGGG	AT%
GTGGCTGGATTTCCAGCCCTGGG	AT%
CAGCTGCCCTGGACAGAGCAGGG	AT%
GTCCTTAGGTCCCACTCAGAAGG	Secondary structure or energy
CCGCTCTGGTGGATATCATCGGG	Multiple matches in exons
AGCTCTGCCACCACTGTCCTAGG	AT%
AAACCCCCGCCCATTGCCAACGG	AT%
CAGACTTGCCCCTCTGGTAAGGG	Secondary structure or energy
GGATGAAGTAGGGCTGGGTCAGG	AT%
CACTGTTGGGTGACAGCCAGAGG	AT%
CCCCAAGTATAAAAGAGCTTAGG	Multiple matches in exons
GGGTAGGGTGGACTGGCAGGTGG	AT%
GGCACGCTAGCACTTGGCAGTGG	AT%
GGCCTTTGGCTCTGCTTTGATGG	Secondary structure or energy
CTGCTTGGCAGGGAGTCTGTGGG	AT%
CAGAGCCTCTGGACAGCACAGGG	AT%
CCAGGATGTGGTAACAGCATTGG	Multiple matches in exons
GCACTGCCTCCTTCCCCCACGGG	AT%
CCAAGTCCTGCAGAGGGAATGGG	Multiple matches in exons
AGGCCCTGTGCCAGTGGTCAGGG	AT%
GTGTGTCCAGAGTCGTGTGCTGG	AT%
AAGGGGACTCCCAGCTCAGCTGG	AT%
GGGCCCCCAGGGGTGGGAACTGG	AT%
GCAGGGAACTATCATAGCTCTGG	Secondary structure or energy
CCTAGGCAGCTCTGGGCCCTGGG	Multiple matches in exons
GAGGGACTGGGGAGTCTTGGGGG	AT%
CAGCTATCAGGGTGGAGAACTGG	Secondary structure or energy
GCAGGTCGGGGAAGCCGCCCAGG	AT%
CCTTGGGGAGCCCAGGATGGAGG	Multiple matches in exons
GGCTGGGGCTCCCTTACCAGAGG	AT%
CCTGCTAAGGTAAGCAGCTTGGG	Multiple matches in exons
AGCTAGCCCTGAGGTAGTCAGGG	Secondary structure or energy
GGGAGTGAGGTCTACCTCGGTGG	AT%
GAGGCGGCTCTAGGCAGCGGGGG	AT%
GGGGAAGGTCCTTCCTGTGGAGG	AT%
GCCTTGGCATCGTGGGGAAGAGG	AT%
GCGGAGGCCGGGCCAGGGGTCGG	AT%
CCATAGCCAATCAGCACTGCTGG	Multiple matches in exons
AATCAATTGAATTGAGGTTTTGG	TTTT
ACGTCATGCCGCCCATACAGAGG	AT%
CAGCTGGCCTGCCAGTTCTCAGG	AT%
GGCGCTCAGCATCGCCTGTCAGG	AT%
CCATGGAGGGGATGGGGCTCTGG	Multiple matches in exons
CCGTGTACATCGGCATGCTGGGG	Multiple matches in exons
AGCCCCACTCCCAGCCTCTCTGG	AT%
CTCCCAAGATCTATGTTCCTGGG	Secondary structure or energy
ACCAGGAGAAGCCGTTGCTGAGG	AT%
CGGTGTCGGGGAGCCCGGAGGGG	AT%
CTGTGTGCCTGGTAGTCCGGTGG	AT%
CAGTTGACTTGAGGCTGTCAAGG	Secondary structure or energy
ACTCGGTGACTGCTGGAGTCTGG	AT%
AGGTGCCTCAGGGTCTCCGTGGG	AT%
GGGGGTGCATGTTGATATCGGGG	Secondary structure or energy
CTCGGGAAGCTCGCGCAGCCCGG	AT%
ATCCCAGCTGTTGCTTCCCCTGG	AT%
CCAGCAGGCACCAGATCTGGGGG	Multiple matches in exons
CAGACCTTGCAAACAGTGGGTGG	Secondary structure or energy
CACTCCATGCCACATCTGGGGGG	AT%
ACTTTCTTTGCACTCCTGCTGGG	Secondary structure or energy
CTTCTATTCCAGAAGTTCGAGGG	Secondary structure or energy
GTCTATGTCTACTTCTGTCTTGG	Secondary structure or energy
GGGTGGCTTCTCTCCACTCCAGG	AT%
GAGGGCCTACCTGGGTGGTTTGG	AT%
CCCACACCCAAGAGGAGTGGTGG	Multiple matches in exons
GGAGAATGTGGGGGCTGTGAAGG	AT%
ATCATCTGGCTGAGCATGCGTGG	Secondary structure or energy
CACTGGGAACTGGGCTCGGGGGG	AT%
CCACGCCCTGGCCGCCCCGACGG	Multiple matches in exons
GCCCCAAGGAGATGACCAGAAGG	AT%
CTGAGAGTCAAGTACCTAGCTGG	Secondary structure or energy
CAGGAGTCTGTTGTGGGGTGGGG	AT%
GTTGCACTTGGTGGTCGCTCAGG	AT%
GTGGAGCTCACGGTTGGGAGAGG	AT%
GCTGGGCGGAGGCCGGGCCAGGG	AT%
GCATAGAGTCTCCGGGGTTATGG	Secondary structure or energy
GGCGCGCACACGCGGCGCGCAGG	AT%
CTGGAAGAAGGGACTCTGCGAGG	AT%
CCTGGCTGCTGAACCAGTCCCGG	Multiple matches in exons
GTAGGACCTGTGGCTCATGCTGG	AT%
GTCTCCCCTCACCATGGCAGGGG	AT%
CTTCCTGGAGCCAGAAGTACTGG	Secondary structure or energy
CCATGACGATGATGTGGGACAGG	Multiple matches in exons
GCTTCCACCAAGGCATCCGAGGG	AT%
GAGGGCGGCTGGAAGACAATGGG	AT%
CAGGTGGCTGCCAGCTGCAGAGG	AT%
AGTTTTCAGACCAAGAAGTCTGG	TTTT
CCATCTGGACCTGGACTTCGTGG	Multiple matches in exons
CCTATGAGGGTGGCTCCATCAGG	Multiple matches in exons
GAAGGCAGCACCCTTATGGGTGG	AT%
CGCTGCCTAGAGCCGCCTCCAGG	AT%
CATCCAGTGGAGCAGGTGCCGGG	AT%
ACTACCTACCTGCCACTCCCTGG	AT%
CCGTGGGGTCAAAGACGCAGAGG	Multiple matches in exons
AGGGTCAGGCAGGGAGGGGTGGG	AT%
ACCCTAATTCTACCACCAGGTGG	Secondary structure or energy
GAGCTAGCCCTGACTACCTCAGG	AT%
CAGGTGCACCCTCCCCAGGTAGG	AT%
ACCAGTGGCACAGGCCGCAGAGG	AT%
GCGGCTCTGAGGAGCCCGGAGGG	AT%
GATCAGCTGGGCCTGTGGCAGGG	AT%
CTTCCCTCGCTTTATCCAGGAGG	Secondary structure or energy
CTGCGCTGCCTCTGGATCGAAGG	AT%
GGGTTTCTTTTCAGGCCCGTGGG	TTTT
GGCATAGTGGGGAAGAGGCTGGG	AT%
GGATACTGGACACCCAGCCAGGG	AT%
CCTTTGAATGGCCAGAGTCCTGG	Multiple matches in exons
AAGTGAGATGCCGGTGGGACAGG	AT%
GGTGGCAGGGAACGGGCACGGGG	AT%
AGCCCCGCTACAGCCTGGCCCGG	AT%
AGAGTTCTGGTACCCCTCCCTGG	AT%
GCAAGTCACCCACACTCCCTGGG	AT%
AAGTACATAGGGATGAGCAGCGG	Secondary structure or energy
GGGCGATGGTCAAATCACTGGGG	Secondary structure or energy
CCCTCCAGCACCAGAGGCCAGGG	Multiple matches in exons
CTTCTACTTTGGCAGGGGAGGGG	Secondary structure or energy
GCTCATGCTGGCAGACTGTGGGG	AT%
GTGCTCCGCGGGCGGCCCGGAGG	AT%
CAGGACTGGCCAGAGGTTCCAGG	AT%
CGAGCCACCGGTCGGTGCGCAGG	AT%
AGGTGGCGCAGCGCTCCGGGCGG	AT%
ATCCAGTGCCAGGTGACAGTGGG	Secondary structure or energy
GCACCTTGACACCCCAAGGATGG	AT%
ACCACCTACAACCAAGGGTGAGG	Secondary structure or energy
GTTCCCTGCCACCCGGGGTAAGG	AT%
ATCCTCACTACAAGGGAAAAAGG	Secondary structure or energy
GGAGTCAGGGCAACTCTGGTTGG	AT%
AGAGGTGCCCTAGAGAGACAGGG	Secondary structure or energy
GGAATGGCCGGTGGCCCGTGGGG	AT%
CCTCATAGGGCTGAACCAGTGGG	Multiple matches in exons
GGGCCAGCCATAGGCGGCTAGGG	AT%
ACTCACCGTGAAGGTCATGAAGG	Secondary structure or energy
AAATCATATTTTTGTGGGAATGG	TTTT
GCGGCCGGAGCGCACGCGGCGGG	AT%
AACATCAGAGCCAAATCCTGGGG	Secondary structure or energy
GGTAGGGTGGACTGGCAGGTGGG	AT%
ACCCGCCCCCGGGGGTCGCCCGG	AT%
GGCAGGATCTGTAGCAGGACTGG	AT%
GCTCCAGAGTCCTGGAGATGTGG	AT%
CCAGATGTGGCATGGAGTGAAGG	Multiple matches in exons
GGGCTGGCCCCGTGGCCTGTGGG	AT%
GATTTAAGGACATTTTGCTATGG	TTTT
GCTGCGCGAGCTGCGCATCCTGG	AT%
CACAGCTTGCTGCTGAGGGCTGG	AT%
AGGTCAGACTGCTGAATCTGTGG	Secondary structure or energy
CAGTACTGCACAGAGGATGAAGG	Secondary structure or energy
AGAGGCCAGCTGTGCTGCCCTGG	AT%
CCTACCAGACCCCTATGTGAAGG	Multiple matches in exons
CCTTTCCCGAGGGTGCCCGGAGG	Multiple matches in exons
GAAGGGGTCAACTGAAGCCAGGG	Secondary structure or energy
GATCCTGCCTGAAGCTGTGAAGG	Secondary structure or energy
CCTTGGTGGGGGTCACCCCAGGG	Multiple matches in exons
ACGGGCGCAGCTGCCAGATACGG	AT%
GCGGGCCCCTCCCGCGGCCCGGG	AT%
GATGTTGGTGACTGGCAGTGGGG	Secondary structure or energy
GCTGGCACGGCATGGGGCACTGG	AT%
AGATGGCTGCAAGGAGAGGCAGG	AT%
GCATCAGGACACCCAGGTAGGGG	AT%
CCCTGCCACCCGGGGTAAGGAGG	Multiple matches in exons
GGGTCCCTGGGCGAGGGGTTAGG	AT%
GTGGTTCCACCAGTTGGCTGAGG	AT%
CCAAGGAGACAAGGGCACAAGGG	Multiple matches in exons
GGCTGCCTCGAGCGCGCGCCCGG	AT%
GCCTTCACTCCTGTGCCCTGGGG	AT%
CAGGGCACTGATTCTGAAGATGG	Secondary structure or energy
GACCTCAGAGCTTGCTGCAGAGG	AT%
CCAGGGGATGGTCCGCTCCCAGG	Multiple matches in exons
GAGTCCCTGGGCTGACCTCTGGG	AT%
CATGGTCACGGGCCCCGGCCCGG	AT%
GGTGCAGCTGGATGACACAGAGG	AT%
CCCTTGTGCCCTTGTCTCCTTGG	Multiple matches in exons
GTTTTGTTTAGCTTTTCTTTGGG	TTTT
GGGAGGGGGCCATGGCGCCCAGG	AT%
GCAGACTGTGGGGCTGGAGTAGG	AT%
CAAAAGCCCTCCCCTCCCTCTGG	AT%
GGAGCCCAGGATGGAGGTGGCGG	AT%
GGCAAGGTAGGACTGGGCTGGGG	AT%
CGGTGGGCACGCCAGACTCGGGG	AT%
GCCCCTGCTCACAGCCTTCGCGG	AT%
CTGCTTGAGGGGGTCAACCTTGG	AT%
CCCTCTTGTCCCTCGTCTTGAGG	Multiple matches in exons
GGAGCCTCACCCTTGGTTGTAGG	AT%
GGGCAAGGGCTCCACGGAGTGGG	AT%
AAAGCTCTGAAGGGCAGCGCTGG	AT%
CCACCACTGTCCTAGGATCTTGG	Multiple matches in exons
GGGACCGCTGGCGATGACTGGGG	AT%
CCCAGATGCACTACTTCTAAAGG	Multiple matches in exons
CATTCTCACGGATGGCACTGGGG	Secondary structure or energy
CCTTCCCTAGATCCCCTTTTTGG	Multiple matches in exons
CTGGTGGGCCCCAGAGCCCTGGG	AT%
ATGACCCAGAGCACCCAGGGTGG	AT%
CCCACCTGGCGGGCCTCTGGAGG	Multiple matches in exons
CAGGCCTGGTCTGGGACCGCTGG	AT%
CAGGGCAGCTCTGGGGCCCCCGG	AT%
CGCACGAAGCGGGTGCAGGTCGG	AT%
CAGGGCGTGGCGATGCCGGGTGG	AT%
ACTTCCTGGGCGATGACACCTGG	AT%
CCATCTGAGCCGCGTCCTGCAGG	Multiple matches in exons
CAAGGTCTGGTTCGGCAGGATGG	AT%
GGAAGGCACGGAAGGCATCCTGG	AT%
GGGCCTTGAGGAGGCCATGGAGG	AT%
GTACTGGGGGCGCAGGAGGAAGG	AT%
GCCCACTTGTTCTGCTGATGCGG	Secondary structure or energy
CAATCATATCTGCTTCAGATAGG	Secondary structure or energy
GGCTCAATTAAGTGAGATGCCGG	Secondary structure or energy
CTGTTTGCATGCCTGGGAAGAGG	Secondary structure or energy
AGACCCCGAGGGCTCAGCCAGGG	AT%
CCTGTATGACGCTAACTACAAGG	Multiple matches in exons
CAGCAACAGCCGTTGCCCACGGG	AT%
GGTTGGCTACAGCATGACTTTGG	Secondary structure or energy
AGCTCAGGGGCTTTCAGGTGCGG	AT%
GGTGTTCTGGTGCCACCTGGTGG	AT%
GGTCCAAATAGGAGCCACTGAGG	Secondary structure or energy
GGCTGCAGCCGAGAGAACCTGGG	AT%
CAGTACAGTTCAGGTGAGAGTGG	Secondary structure or energy
AACCTCAAAGCCATGGACATCGG	Secondary structure or energy
GGCCGAGCCCTGCGGCGGGCCGG	AT%
GTCTGTTGCATCCGCTGGGGAGG	AT%
GAGGGGTACCAGAACTCTACTGG	Secondary structure or energy
CGCGGCTACGGCGGAGACGCTGG	AT%
AAAGCAAAGACTGGGGGAGCGGG	Too close to reverse primer
GGGCCGGAGGTAAGGGGGCCCGG	AT%
GAACACCACGATCCCGGGCATGG	AT%
CAGCTGCTGGTCCCAGATGTGGG	AT%
AGGGAGGCGAGGTGGCAATCAGG	AT%
GCCTGGGTGGAGGGGTGGGGGGG	AT%
CTGCCAGCCAAGGACTTCAGCGG	AT%
GGCTCAGGAGGCTGGGATGGAGG	AT%
CCATGGCAGGGGTGCCGGGCTGG	Multiple matches in exons
GAGATGGTGTTGAAGTGGAGAGG	Secondary structure or energy
CAGCGGCAATGGGCGGTGTCGGG	AT%
ACGGCCGCGGAAAGCGCCGCAGG	AT%
ATGATTCTACGGATAAGTGATGG	Secondary structure or energy
GCGGGTAGGTGCCCCTGAGGAGG	AT%
CTCCTCTGCGGGCTCGACTTTGG	AT%
AGAAGCTGGCCCTCCTGAGGTGG	AT%
ATGGGCGGGGGTTTCCAGCCAGG	AT%
CAAGCCTAACTGCTTCCGCAAGG	Secondary structure or energy
GCTCTCCCCGGGTTCTGAGGAGG	AT%
ACACCACCGAGCAGCTGAAGAGG	AT%
CCACCACTCCTCTTGGGTGTGGG	Multiple matches in exons
CCAGTCCCCTGGAAAAACCTAGG	Multiple matches in exons
GTTGAAAGTGAGTGTGGAGCGGG	Secondary structure or energy
GAGAGCTGCAAGGGAAAAGATGG	Secondary structure or energy
CATCCAGGGCCCCTGAAGTCTGG	AT%
AGAAGGGGTCAACTGAAGCCAGG	Secondary structure or energy
GCCCCTCCCCCTTGCCTTCTGGG	AT%
CTGTGCGTGAGCTGAGGGACGGG	AT%
CCAGAAGTTCGAGGGAGTCCTGG	Multiple matches in exons
AGACAAGCTCTGCTATTCCCAGG	Secondary structure or energy
GCTCAGCAGTGGGAAGGAAAGGG	Secondary structure or energy
CCCCACCAGGAGGCCTGCTAAGG	Multiple matches in exons
ACCCCCGGGGGCGGGTCCGAGGG	AT%
CTGGCTCCAGGAAGAGCTGCTGG	AT%
GAGTCCCCGGCCCCTCCCGTTGG	AT%
ACAGACACTGCCCGCTGTGAAGG	AT%
GGAACATACTTAAAATGACACGG	Secondary structure or energy
GGAAGGTGGGCATCGGAGCCTGG	AT%
GTTCCCACACAGCCTCTGCAGGG	AT%
CCTAAGCTCTTTTATACTTGGGG	Multiple matches in exons
CTCTAACCCCACAGCTGAGGTGG	AT%
GGTTCAGACCCAGCTCCTGCAGG	AT%
ACCTTGAACCCCAGAGTGAGTGG	Secondary structure or energy
ACAGCTGGGATTGGAGGGACTGG	AT%
GGTGGCCCCCCGGGGAGAGCTGG	AT%
GCCTGCCTGTGTGCCGGGAGGGG	AT%
ATCCACCAGCAGCAGGGCAAGGG	AT%
CGCAGGGTTTTCAGCACCCTTGG	AT%
ATTTGTCTGTTGCATCCGCTGGG	Secondary structure or energy
ACAACAGTTGTCTTCCTCAATGG	Secondary structure or energy
GCCCAGCCGGCACCTGAAGCTGG	AT%
CAGTGGGTGGAGAACAGAGTGGG	Secondary structure or energy
AGAGGAAGGGAGTGCCTGCTAGG	AT%
GCAGCAGCTGGTGTAGCACCTGG	AT%
CCTCCCCCTCCCCCCAGCCTGGG	Multiple matches in exons
AAGACAGCCTGGAGAAGGCCAGG	AT%
GGAGGGAAAAGTTCCCTGCGCGG	AT%
CTCCGGCCCGCCGCAGGGCTCGG	AT%
CGGGTGGCAGCGCCAGCAGACGG	AT%
CCGCATCAGGACACCCAGGTAGG	Multiple matches in exons
CCTTGGCCCGCAGATCGGAAGGG	Multiple matches in exons
CAGGGGAGGGGGACAAATGGTGG	AT%
GCGTGATCCACACGAACCAGTGG	AT%
AGATTGGCCATGAAAAGCATCGG	Secondary structure or energy
CAGAGACCAGCAGGACATCGCGG	AT%
CATTCATGCATAGAATTCTGAGG	Secondary structure or energy
GAGGACCTGGTGGATGCTGATGG	AT%
GTTCCGGCGGCGCTGGTCTGTGG	AT%
GTTGTAATTCTCCAGCACCTGGG	Secondary structure or energy
CTAGGTTCCTGGAGAGCCACTGG	AT%
AGCCAGCTGGCAGAGACCACAGG	AT%
CCAAGCAATAATAGGAGGTGAGG	Multiple matches in exons
ACTGTGCAGCCTGACATCGGAGG	AT%
CATCCAGACTTCAGGGGCCCTGG	AT%
CTGGACTCATGGGGTGGGGCTGG	AT%
CTGGGGTGGGGGTAGGGGTGGGG	AT%
GGTCTCCCTCAGCTTCTCCGTGG	AT%
ATGCGCTGGCCTGTCCTCCCAGG	AT%
CCAGGTGACAGTGGGCCTTGAGG	Multiple matches in exons
CTGATGAGGAAGCCCACCTGTGG	AT%
GTACACCAGCCCAGTGAACCCGG	AT%
CTGGCTGTGTACTCACGAGCAGG	AT%
AATCTGAACTGGAACGGAGGGGG	Secondary structure or energy
CCCAAGCTGCTTACCTTAGCAGG	Multiple matches in exons
AAGTGTGAGCCCAGGCCCAAGGG	AT%
GGCTGGGGGTCCGACTGGGGAGG	AT%
AGTCCTCTTCCTCCTGCTCTGGG	Secondary structure or energy
CTGGAGTCTGCTATTTCCAAAGG	Secondary structure or energy
CCCTGGTTCCAGGTGAGAACCGG	Multiple matches in exons
ACAGGTAAGGACAGAGACCTGGG	Secondary structure or energy
CCAGAGGAACCCAGCCAGGATGG	Multiple matches in exons
ATATGTGAAGATGAGTTCGGGGG	Secondary structure or energy
CTCGACCGCAACCGCCTGGGCGG	AT%
CCTCACCATGGCAGGGGTGCCGG	Multiple matches in exons
GGGGGAAGCTGGAGTCTGAGAGG	AT%
GAAAGCAAAGACTGGGGGAGCGG	Too close to reverse primer
CCGGGATCGTGGTGTTCCGGCGG	Multiple matches in exons
CACACAGCCCTCTTTGCTGCTGG	AT%
AGCTGAGAGCCACCAAGAGGAGG	AT%
GGAAGCCGCCCAGGCGGTTGCGG	AT%
CAGAGGTGAGCAGGCCGACCTGG	AT%
GGTCGTGATCAATGTGCATGGGG	Secondary structure or energy
CTGGAACGGGGTACTTGCTGGGG	AT%
GAGCCATAGCAAGCTTGGCGGGG	AT%
GCCTTTGGCTCTGCTTTGATGGG	Secondary structure or energy
CTACCATAGATGTGGTGTTCTGG	Secondary structure or energy
CACTTGGAGGCACAGGTCAGTGG	AT%
GGCCCCATGCCCTGCAGCGGCGG	AT%
ACCTACCAGCACTGCTCAGCAGG	AT%
CCTGAGTCTGGGGGCGAGTCTGG	Multiple matches in exons
AGCGTCACTATCGTCCTCTGCGG	Secondary structure or energy
CCTGCTTCACATCCTGCTGCTGG	Multiple matches in exons
GGCCTCCTGCCCCAAGAGAGAGG	AT%
GGCAAGTCACCCACACTCCCTGG	AT%
ACAAGGCCTTGAGCTCTGGCTGG	AT%
AGGGGGCCCCCGCCAGCTGGTGG	AT%
AGGAACGGGTCTCCGTTCTGCGG	AT%
CACAGGGAGTGGAGAGAGGGTGG	AT%
CCAGAGCAAAGTTGTCAGTGAGG	Multiple matches in exons
CCACCCTTCTAGGGTCAGGCAGG	Multiple matches in exons
GAGTGAGGTCTACCTCGGTGGGG	AT%
GCGGCTACGGCGGAGACGCTGGG	AT%
CCAGGACTCCCTCGAACTTCTGG	Multiple matches in exons
CCGTGGCGTCCTCCGCACCGTGG	Multiple matches in exons
AGCTGGTGCCACTGGGCCACAGG	AT%
GCTTCTGCTGCTGTCCACCCAGG	AT%
AGCCTCTGGACAGCACAGGGAGG	AT%
GGTCTCCTACCAACCGCACCTGG	AT%
AGAGGAGGCAGCGCAATCTGCGG	AT%
CTCCGATGCCCACCTTCCGTTGG	AT%
AAGCTCTGAAGGGCAGCGCTGGG	AT%
ATTGCAGTGCTTAGCTTGAAGGG	Secondary structure or energy
ACAGAACGTCTATTCAGACAGGG	Secondary structure or energy
CAAGGTAAGGGATGCCCATGAGG	Secondary structure or energy
GGCGGGACACCAAAGAGACAGGG	AT%
CACTCAGGTATGGATGTTTTGGG	TTTT
GGTCTCGTCCACCACCTCCATGG	AT%
ATGGCAGCATAAGGGGGTACAGG	Secondary structure or energy
GTGGATCTGTGCATCCTGCTGGG	Secondary structure or energy
CTAAGGGGAACAGCATGGGCAGG	AT%
CGGGTGGCAGGGAACGGGCACGG	AT%
GGTGGTGGGGTGGCCCCCCGGGG	AT%
CCTGTCATGCTGTTCCCAGGAGG	Multiple matches in exons
GTTTAGACATCCCTTTTAAAAGG	TTTT
CAAGGGGGTGCTGGTGTCCCAGG	AT%
CCTGATCCTGGCCATCTCTCAGG	Multiple matches in exons
GCGCGAGGACGCGGCTACGGCGG	AT%
CTCTCTCTCTCTTCTTCCAGGGG	Secondary structure or energy
CACTCACCCTGGGGCATAGGGGG	AT%
CTACTATTCCTAGTAGTCTGAGG	Secondary structure or energy
GGCTCATGCTGGCAGACTGTGGG	AT%
CCCTCCCGTTGGCAATGGGCGGG	Multiple matches in exons
CGACGCCTGTCTCCACAGTATGG	AT%
GTGTTGAAGTGGAGAGGAAGGGG	Secondary structure or energy
GTCAGCGCGGTTATAAGGGAGGG	Secondary structure or energy
CACCCCATGAGTCCAGCTCAGGG	AT%
CGCGCGGAGCCTCCTCCCTCTGG	AT%
AAAGCACTTATCCTCAGGATAGG	Secondary structure or energy
GCTGCTGACAGGGATGTGGTAGG	AT%
CCAGGTCTCGCCCAAAGGCCTGG	Multiple matches in exons
CAGCTGGGATTGGAGGGACTGGG	AT%
GGGTGGAGGAACTAGGGAATAGG	Secondary structure or energy
AATGGTCCCAGCGGCACCCGGGG	AT%
AGCCTGAGTGGGGCCAAGGGAGG	AT%
AGCTCAGCTGGGGCCCCCAGGGG	AT%
AGCCGCCTCATCGGCCACCACGG	AT%
CTGGTTCAGCCCTATGAGGGTGG	AT%
CTTCGATCCAGAGGCAGCGCAGG	AT%
GGACTCAGCCCTAGACACGAAGG	AT%
CCCCAACACCTACCTTTAAGTGG	Multiple matches in exons
CCTACCTGGGTGTCCTGATGCGG	Multiple matches in exons
CTACCGGAGGGTGGCCCCCCTGG	AT%
CCAGATGCAGACCTTCTGGAAGG	Multiple matches in exons
CAGAAGGATCACAAGTTCAAAGG	Secondary structure or energy
CACGGGCCTCAGACTATCACAGG	AT%
AGGGATCTGTGCTGGGGGGTTGG	AT%
CTGGTGCCCCTTATCTTCATGGG	Secondary structure or energy
ACCGGTTCTCACCTGGAACCAGG	AT%
CGCGGCCGCAGGCGGCTCTGAGG	AT%
AGGGTCAGGCTGAGGTGCAGTGG	AT%
ACTGTTGGGTGACAGCCAGAGGG	Secondary structure or energy
CATCTCGGCACGCTAGCACTTGG	AT%
CTCGTAGTGTAGGCCGTGCTTGG	AT%
CCTGACCAACTCATGATTCCTGG	Multiple matches in exons
AGCTCCAGGGCCAGGCCAGTGGG	AT%
AGAGTGGGGTGCTAGCCGAAAGG	AT%
GCGAGAGCATCCGTGGCATTGGG	AT%
CTTTTGCCACGGTCCAGGCTGGG	AT%
CCGGCCCATGCGCAACAGCGCGG	Multiple matches in exons
CTTTCCCCAGGCTGGGGGGAGGG	AT%
CTGGATGGAGGACCTGGAGAGGG	AT%
GGCCGGAGGTAAGGGGGCCCGGG	AT%
CGAGGGAGCCGTCGAGCGCATGG	AT%
ACGCGATCTCTATTTAATAAAGG	Secondary structure or energy
CAGCACTCACTTCATCTGCAGGG	Secondary structure or energy
CATGATGGGGAGCCAGGCCTTGG	AT%
CCCTTTTTGGGGCCCAGAAGAGG	Multiple matches in exons
CAGCTGGGGCCCCCAGGGGTGGG	AT%
CCCCAACTCCCTTGCCCAGCTGG	Multiple matches in exons
AAGCGCTAACTGATGAATTCCGG	Secondary structure or energy
AAGGACCAGAGGGGCCCCGAAGG	AT%
CCACCAGTTCCCACCCCTGGGGG	Multiple matches in exons
GAAGGCAGAGAGGTGCCACTTGG	AT%
CACAACCTCCCCCATGAGGTAGG	AT%
CACTTTCCAGTTAAGGACTGAGG	Secondary structure or energy
GTTAAGTGTCGCATTAGCACGGG	Secondary structure or energy
AGCCATAGCAAGCTTGGCGGGGG	AT%
CAGAAAGAGCTGCTACTCTGGGG	Secondary structure or energy
CTGAGAGATGGCCAGGATCAGGG	Secondary structure or energy
GAGGAGGAGCCCTGTGAGGAGGG	AT%
GGTGACCTTCACGAGCCTCTTGG	AT%
ATTTGTAGCCTGTGCCTACATGG	Secondary structure or energy
GCCACTCACTCTGGGGTTCAAGG	AT%
ATTGAAGCTGGGGCTGTTCTTGG	Secondary structure or energy
CGGCAGGGGGCAGGGTGACCAGG	AT%
AGACAGACAAAAGGACAGCCTGG	Secondary structure or energy
AGGAGACTGAGGCAGATGGAAGG	Secondary structure or energy
CGGCCTGCCTGTGTGCCGGGAGG	AT%
ACATACCCACGGAGAAGCTGAGG	Secondary structure or energy
CACAGGTGGGCTTCCTCATCAGG	AT%
GGGAAAGTTGGTGGCTCAGTGGG	Secondary structure or energy
CCTCCAGAGGCCCGCCAGGTGGG	Multiple matches in exons
GCTTTAAGTGTGGTTGGTTTAGG	Secondary structure or energy
GGATCGCCTAGGCCTACCCTAGG	AT%
GATGTCAGGCCTCACCTGAGAGG	AT%
GCTCCGAGCACCTTGGTCTTTGG	AT%
ACAGCTTGCTGCTGAGGGCTGGG	AT%
CAGGCGGATTCGATGGTGGCAGG	AT%
GCAAGCTTGGCGGGGGAAGCTGG	AT%
AGGATACTGGACACCCAGCCAGG	AT%
CTAGGCTGATTCTCTATGGTTGG	Secondary structure or energy
AGTCTGCCAGCATGAGCCACAGG	AT%
CGTCACGCTCCAGTACTGCATGG	AT%
AGCTGGATGGAGGTCAGGGATGG	AT%
CCTTCTAGGGTCAGGCAGGGAGG	Multiple matches in exons
AGCCTCCACTTCCTGGGAGGAGG	AT%
CCTGCCTGACCCTAGAAGGGTGG	Multiple matches in exons
GCGGTCCCTAGAGGCTCTGTGGG	AT%
CCCATCATGATGTGTGAGGCAGG	Multiple matches in exons
GGCCTGTGGGGGTGGAAGTCCGG	AT%
CACACCCAGCTTACCTCCACAGG	AT%
GGGGGAGGTGGCGGTGGTGGTGG	AT%
GCGGCGGGCCGGAGGTAAGGGGG	AT%
GAGGGCTGGGTGAGTCCCCCAGG	AT%
CCAACAGTGCCCCTTTCCCGAGG	Multiple matches in exons
CTTGGTCACGTACCGGGGTCCGG	AT%
CTGGCTGCTGAGGCCCGTGGGGG	AT%
GGTGCACCTGGCGGGTGCCAGGG	AT%
CAGCAGAGCTGCAGTCCCGGCGG	AT%
GATCAATGTGCATGGGGATATGG	Secondary structure or energy
AGCAGCAGCTGGAGCTGAGCGGG	AT%
CGTTGCAGGTTGCCTGCAGCTGG	AT%
GCTCGGTGCTCCCCTCTCCCTGG	AT%
ACCTTATTGGCCAGTTTAGGGGG	Secondary structure or energy
CCCGGGCCGCTCCGGCCTCGGGG	Multiple matches in exons
GTGCCTCTACTCCGTCACCAGGG	AT%
CCATGCCCTAGGCCTCCTGGGGG	Multiple matches in exons
CCGCAATGACCCCATTGGGGAGG	Multiple matches in exons
GAGCAAAGACCCACAGGGGTTGG	AT%
AAAAATATGATTTTGCAAAGAGG	TTTT
ACACGCGGCGCGCAGGCCAGAGG	AT%
AAGTATAGAGGCAGCAAGGCTGG	Secondary structure or energy
GCCCGCGCGGCCCCCGCCCTCGG	AT%
CGATGACACGGTGGCCCCCCGGG	AT%
AGGAGTGGTGGGTTTGAGTTTGG	Secondary structure or energy
GTTGTCTGGTGCAGGTTCCAGGG	Secondary structure or energy
GGAAGATGTTGGGCTTGGCATGG	Secondary structure or energy
CTACCTGGGTGTCCTGATGCGGG	AT%
GGCGGTGTCGGGGAGCCCGGAGG	AT%
CCAGCCCGGCACCCCTGCCATGG	Multiple matches in exons
GGTCTGGGTCCAACCCCTGTGGG	AT%
GGGCCATGCCCTAGGCCTCCTGG	AT%
CAGCAGCTGGGACACGGTAAGGG	AT%
CAGGCGGGCCATGGAGGTGGTGG	AT%
CACCCTCTCTCCACTCCCTGTGG	AT%
GGCAATCTTGGGGAGCGGAGGGG	AT%
GAACTTAGAATTACAGGCTGGGG	Secondary structure or energy
AGAAGAAAAGGACTGTCTTGGGG	Secondary structure or energy
ACTGCCCAGAGGTCAGCCCAGGG	AT%
AACTCTCCTTGTGCCGGCTGGGG	AT%
CCCGAGCAACCTGCACCAGCAGG	Multiple matches in exons
GTGAAGTTGCCAAGCCTAAAGGG	Secondary structure or energy
GCGTAGGCTCCTGCTTTCTGGGG	AT%
GCTGAGGCACTGCCTCGGCAGGG	AT%
AAAGAGCTGCTACTCTGGGGTGG	Secondary structure or energy
CAGCCTGGGGTCAAGGACAGTGG	AT%
GGTCAGTCAGGGCATCCTTGGGG	AT%
GCTGTCCACCCAGGAGCGACTGG	AT%
CTTTTGGCCCCTCATCTTATGGG	TTTT
AGGCAGCTCAGTCACACAGGCGG	AT%
GGAGTCACAGAGTCAGGGGGAGG	AT%
CTGGGGGAAGAAGCCAAGCTTGG	AT%
GCTGGGTAGCGGCTGCTATGAGG	AT%
GGAGCCTCAGGACGTAACCCTGG	AT%
AATCAGCACTGCTGGTCCCAGGG	Too close to reverse primer
GAGTTTTTCTCGCCCGTAGCTGG	TTTT
CCTTCTGGGTACCAAACTTGAGG	Multiple matches in exons
CTCGGGGTCTCCCCTCACCATGG	AT%
GGCCCAGTAGCTTTGGGGAGAGG	AT%
GGCACACAGGCAGGCCGGGGCGG	AT%
GGGTTTGCACAGGGTGCAGCTGG	AT%
CTGATGTTGGTGACTGGCAGTGG	Secondary structure or energy
GGCCATGGCACATGTCCAACAGG	AT%
GGTTTAGGAGAGTTTTCCTTGGG	TTTT
ACAGGCTGAGAGAAAAGATCCGG	Secondary structure or energy
GAGAGGTGCCCTAGAGAGACAGG	AT%
CTCAGATCACCGAGGACTTCAGG	Secondary structure or energy
AAACTACACTTAGGAAGTTAAGG	Secondary structure or energy
GTCCCTGGGTGCTGCCCTGGCGG	AT%
CCCACTTCCAGGTTGCCTGCAGG	Multiple matches in exons
CACCTGTGGTCTCTGCCAGCTGG	AT%
AGTGGACCTTCCTGACCTGGAGG	AT%
CAAGCACGGCCTACACTACGAGG	AT%
ACCCAGCTGGGCAAGGGAGTTGG	AT%
GAGCAGCAGCTGGAGCTGAGCGG	AT%
GCCTCCTGCCCCAAGAGAGAGGG	AT%
CTGGGACCAGCAGTGCTGATTGG	AT%
CGCTGGGTGCATCAAGGTAAGGG	Secondary structure or energy
GCGTATGACCCCATGCCTCTGGG	AT%
GAAACCTAGGCAGCCCAGAGAGG	AT%
CCCTCTCTCTCTCTTCTTCCAGG	Multiple matches in exons
CCGCCGGAACACCACGATCCCGG	Multiple matches in exons
ACTGGGGGAACATGGAAATGGGG	Secondary structure or energy
GGAGCGGGGAAGTTCCGAAGGGG	AT%
GTGTCCCAGCTGCTGTGAGCAGG	AT%
CACAAGGAGAGTTGTGGGTCTGG	Secondary structure or energy
CAAGGCTCGGAGGCTGTCCCTGG	AT%
CCTGGGCGGCAACCGTCTGCTGG	Multiple matches in exons
CTTGTCAGCGTCCACACGATAGG	Secondary structure or energy
GGGCCTTGGGGAGCCCAGGATGG	AT%
GCTGAGCGCCTCCCTGTGGAGGG	AT%
CTCCCCCTGCCACTCACTCTGGG	AT%
CAGGGCTCTGGGGCCCACCAGGG	AT%
CCCACACTTACAGGGTCCCCAGG	Multiple matches in exons
CTCCCTTCTATGGTGCCACTGGG	Secondary structure or energy
ATTGAAGAGGAGGAGGCCGCAGG	AT%
AACCCGGGCCTTTGATGATGAGG	Secondary structure or energy
GCAGGGAACGGGCACGGGGAGGG	AT%
CAGACTCATCGTGTGGCGTCTGG	AT%
GCCTCACAACCTCCCCCATGAGG	AT%
CTGAGAGCTGTGACAAATCAGGG	Secondary structure or energy
GCTGGTGTGCATGCAGTGGACGG	AT%
ACACAGCCTCTGCAGGGAGTTGG	AT%
AAGTTCCCTGCGCGGAGAGCCGG	AT%
CATCTGAGCCCCCCTGGGAGCGG	AT%
GGTGGCCCCCCGGGTGCCGCTGG	AT%
CCCCACCCCTCCACCCAGGCTGG	Multiple matches in exons
CAGTGCTGAGACTCACCAGGTGG	AT%
ACCCAGCCTGGGTGGAGGGGTGG	AT%
GTGTGTGTTGGGGGTGGGGCCGG	AT%
GCAGATGGGGTGCATACCGAGGG	AT%
CCAGAAAATGCTGAGGACTGAGG	Multiple matches in exons
CATAGGAGGCGCAGGACCCAGGG	AT%
GTTGCAGGTTGCCTGCAGCTGGG	AT%
GCGAAAGACTCATTGAAGATGGG	Secondary structure or energy
GGGGAGTCATCTGTGGAGGTAGG	AT%
CCTAGGGGGTCAAGGCAGGAGGG	Multiple matches in exons
CTCCTCCTGCTCACAGCAGCTGG	AT%
GAGGAGGATGAGGCCCACGAGGG	AT%
CCTGCCGAACCAGACCTTGCTGG	Multiple matches in exons
CCACGGCAACGTGAAGGTCATGG	Multiple matches in exons
CTGTGCCTACATGGCTTCCCAGG	AT%
AGCTGAGCTGGGAGTCCCCTTGG	AT%
CTGTGCTGGGGGGTTGGGGGGGG	AT%
CTGAGAGTACCATGCCCTGGCGG	AT%
GGACACTCAGGGACACTGTCAGG	AT%
CTCCGACATCATTGCTGGCCTGG	AT%
CAAGGGTGAGGCTCCTTTCCTGG	AT%
GCTCGGAGGCTGTCCCTGGTGGG	AT%
CGGGCATGGCTGGCAGCTCTGGG	AT%
GAGCAAGGAGCTCAGCCCTGGGG	AT%
AGCCAGAGCTCAAGGCCTTGTGG	AT%
GTCCCTCACCGCATCGTGACAGG	AT%
GCTCCCCTCGGCTCCCCTATAGG	AT%
CAGAGCTTGCTGCAGAGGGTAGG	AT%
ATCCTGTCTGTGGTGCTCTTCGG	Secondary structure or energy
CCAGGTCCTCTTCAGAGCGCAGG	Multiple matches in exons
AAGTCTCTCTGCGCCAAGCATGG	Secondary structure or energy
GACCTCAAGAACTCGGTGAGTGG	Secondary structure or energy
AAGTAGAGTATTCTGGGACCTGG	Secondary structure or energy
CTTTTCCCTCCCGAGCTGTGAGG	Multiple matches in exons
CGGGCAGGCGCACGCTCTTACGG	AT%
CATTTGATGGATTGGTAGTTGGG	Secondary structure or energy
GGCACCCCTGCCATGGTGAGGGG	AT%
GCCTGGTAGTCCGGTGGTCATGG	AT%
CCTGGGAGCGGACCATCCCCTGG	Multiple matches in exons
CAGTACCACGGACACAGGGGTGG	AT%
CAGTCATCCTCACCCCCTGCTGG	AT%
GCGTTTGTTTCCTCACAGCTCGG	Multiple matches in exons
CTCTTTTCCTCTGTCAGGGTAGG	TTTT
GGTCATGGGAGAATGGCACGTGG	AT%
CACAGCACAGAGGGGGCTAGAGG	AT%
CCACTGGTTCAGCCCTATGAGGG	Multiple matches in exons
AGGGGATGGTCCGCTCCCAGGGG	AT%
AAGGAGCACGTGCAGGAGGTAGG	AT%
GCACGCCAGGCTCGCGAACTAGG	AT%
GCTCCCAGCGGAAGATGGGTAGG	AT%
GCAAACAGGCAGCTGCCCGTGGG	AT%
ATTTGATGGATTGGTAGTTGGGG	Secondary structure or energy
GACTAGAACTGGCTTCCCTTTGG	Secondary structure or energy
GGGGAAGAGGCTGGGGGAGCAGG	AT%
GGCAAGGGCCCACGTCCTCCCGG	AT%
AAAATGGAGATCTTGGTGGAAGG	Too close to reverse primer
CTCTGGGGTGGGGGTAGGGGTGG	AT%
GGTCGGGGAAGCCGCCCAGGCGG	AT%
GGATTCGGCCCAGGTTCTCTCGG	AT%
GGTGGGGCTGCTTTCTGCCGCGG	AT%
AGGACCAGAGGGGCCCCGAAGGG	AT%
GGAGTGGCAGGTAGGTAGTCAGG	AT%
GAGCCCCAGCCACTAGAGCAGGG	AT%
CCAAGTCATAGAAGCTGAGCAGG	Multiple matches in exons
GGAGTACCAGTGAAGCCTCCTGG	AT%
CTATGGTGAGGACTCCTCTATGG	Secondary structure or energy
AGTACGTGCACAGCTGGAGCAGG	AT%
AATGTACTCCTCCAGGATACTGG	Secondary structure or energy
CGGGCCACAGTAGAGCGAATGGG	AT%
AGCCACATACAGGAGGGCACCGG	AT%
GGAGATCTTGGTGGAAGGCGTGG	AT%
CTGGGAGGAGGCCCAGGGTGAGG	AT%
GATCTTAGCTCTTGACAAAACGG	Secondary structure or energy
ATCCGCCAGCATGACCTACCAGG	AT%
GGAGGCGAGGTGGCAATCAGGGG	AT%
GTCAGAGCTCACGGAGAAAATGG	Secondary structure or energy
GTATAAAAGAGCTTAGGGGAAGG	Secondary structure or energy
CCTTGGGATAAGCCAGCCACTGG	Multiple matches in exons
CTGACCTAGGGGGTCAAGGCAGG	AT%
CCCTGGGGTGACCCCCACCAAGG	Multiple matches in exons
CTTCAGGGACCTGAGAGGTGGGG	AT%
GGGAGTGGTGCCCTGTTGGAAGG	AT%
CACAGGCAGGCCGGGGCGGGGGG	AT%
CTATTCGGGAGAAGATGCTACGG	Secondary structure or energy
GCGCTTTCTGTGGGAGACGGGGG	AT%
CAGTTCCCAGTGGGCTATGATGG	Secondary structure or energy
ATTGTGGTAGGCCACTCCTTGGG	Secondary structure or energy
CGACGGGGCCCGGGCCGCTCCGG	AT%
CGGAGCGGCCCGGGCCCCGTCGG	AT%
GCACGTACTGCATGGAGTCCCGG	AT%
CGGCAGAGGCCACAAGAGGCTGG	AT%
GGCGGCCGCAGCGGCAGGGCGGG	AT%
CCGGGCGGGAGAAGGAGCGATGG	Multiple matches in exons
GCAGGGCCCATGGAATTATGGGG	Secondary structure or energy
ACAATGCTGGAACGTGACATAGG	Secondary structure or energy
CGTGTCTGCCTCTGGCTGCTGGG	AT%
GCAAGCTGTGCTCCTGGGCAGGG	AT%
CTGGGCACAGCGGCACCCAGGGG	AT%
GCAGAGGGTCCTCTACCTCCAGG	AT%
GATGCCGTAGAAAGGGATGTAGG	Secondary structure or energy
GGTCCAGGCTGGGCTCCTCTGGG	AT%
CCTCTGCGTCTTTGACCCCACGG	Multiple matches in exons
GCCTCTTCCCCACGATGCCAAGG	AT%
GCTCACCTCTGGTCAGGGTTGGG	AT%
CTTTTCATGGCCAATCTCCTTGG	TTTT
CCAGGGGTCGGCACCGGGTCGGG	Multiple matches in exons
GGTGGAGGTGTCGGGGCAAGGGG	AT%
ACGTCCTGAGGCTCCCCTGGTGG	AT%
CCAGAGCACCCAGGGTGGAGAGG	Multiple matches in exons
AGGAGGGAGGCTTTTTGCAGAGG	TTTT
CAGCCTGGGTGGAGGGGTGGGGG	AT%
CAAGCATGGCATTGAATACCAGG	Secondary structure or energy
AGCAGACGATGGGGCAGGGCTGG	AT%
GGCTGCGGCCGGAGCGCACGCGG	AT%
GGCCAGCAGGCACCAGATCTGGG	AT%
GGCCGTGGTCCACCAGGTTCAGG	AT%
AATTCTAGCACCTGAGGGCTGGG	Secondary structure or energy
GGGGGACCCGGGCCGCGGGAGGG	AT%
CCTACCCTAGGAGACTGTATGGG	Multiple matches in exons
CTGAAGCTGTGAAGGACACAGGG	Secondary structure or energy
GGGTTTTGTAATCTTCTGGTTGG	TTTT
CCACAGATGACTCCCCCAGGAGG	Multiple matches in exons
CAGGGCGGGGCCGGTGGGGCGGG	AT%
GGAGGCGGCTCTAGGCAGCGGGG	AT%
AAGCCTTCCTCACAGGGTGCTGG	AT%
ATGCGGCCAGGTGGGTAGAGTGG	AT%
GCCACAAGCTGGCCAAGCTGCGG	AT%
ATGTCAGATGACGCTCATAAAGG	Secondary structure or energy
CTCCAAAGTCGAGCCCGCAGAGG	AT%
CTCCACTCACCGAGTTCTTGAGG	Secondary structure or energy
CCTTGGACCCTTGATCCTGGAGG	Multiple matches in exons
AGTTAAGGGGTAGAGGGGAAAGG	Secondary structure or energy
GGACAGTGGTGGCAGAGCTCTGG	AT%
GTAGTTGTGCCGCGGCATGGTGG	AT%
GGCAGCACAGGACCACTTCATGG	AT%
CCCCAAGTCGGAGCTGCCCGAGG	Multiple matches in exons
CCTGCACAGCCTCACCTTATTGG	Multiple matches in exons
AGGGAGGTAACCAGGGAGAGGGG	AT%
GCATCATGCCCACCCTTCTAGGG	Secondary structure or energy
CCCGGCCCCATGGCAGCATAAGG	Multiple matches in exons
GTGTCTACGACATCAGCCGCTGG	AT%
GACCTCGACCGCAACCGCCTGGG	AT%
AGCTGCCTGTTTGCATGCCTGGG	Secondary structure or energy
GACTTACCACCCAGTCCCTGCGG	AT%
GGGAGGGGCCCGCACCGCTGGGG	AT%
ACCCCTGAGCTGGACTCATGGGG	AT%
CCTCCATATGGAGGAGGAAGAGG	Multiple matches in exons
AGCGCACGCGGCGGGCAGGCGGG	AT%
GCCACTTTCTACAATAGCAGAGG	Secondary structure or energy
GGGGAGCCCGGAGGGGGACCCGG	AT%
GAGCCGCGTCCTGCAGGAGCTGG	AT%
ACCGGAAGGCCTCAAGCCCCTGG	AT%
CTGTCCTGGAAGAGCGGACCAGG	AT%
AGCTCTGGCTGGGAAGGAGCTGG	AT%
GCCAGAGAAGTCCAGGGTAGAGG	AT%
CTTGGAAACAGAGTGAGAAATGG	Secondary structure or energy
AGCCACTCCCTGCTCTGTCCAGG	AT%
GCGCGGACCGCCGAGCCCCGCGG	AT%
GATAAAGTTGAGGAAAACCAGGG	Secondary structure or energy
GTGGGGGAGTCACAGAGTCAGGG	AT%
GTACCGCTGAAGTCCTTGGCTGG	AT%
CCTGGAAGAAGAGAGAGAGAGGG	Multiple matches in exons
CTTCTCACACTTGATAACTGAGG	Secondary structure or energy
ATGGTCCCAGCGGCACCCGGGGG	AT%
GGGGCTCAGCCTTCATGTAGAGG	AT%
ATTGGAAGGAAATAGGGGCGTGG	Secondary structure or energy
ACGGCGGAGACGCTGGGATGTGG	AT%
CTACTCTGGGGTGGGGGTAGGGG	AT%
ACGACCCCGATTCGCCCCTGGGG	AT%
CGCTCGTCCCCGGCAGCCTGTGG	AT%
CCACCTGCTGTTTACAATAAAGG	Multiple matches in exons
GACACCCCATGGCTCCAAGCTGG	AT%
GCATGAGCACCTGCCCTATGTGG	AT%
GTTGACCCCCTCAAGCAGCTTGG	AT%
CTTGTCACAGCTCTTACCCTTGG	Secondary structure or energy
AGCCTCTGCAGGGAGTTGGGAGG	AT%
GCTGTCAAGGCGCCGCAGCTTGG	AT%
GCAGTAGAGAGTTGCTACTGGGG	Secondary structure or energy
GGTAGAGCAAAGACCCACAGGGG	Secondary structure or energy
GGGCTCGGCGGTCCGCGCCAAGG	AT%
CTTCTCGATCCAGCCCCTTGGGG	AT%
CAGGGGGAGGCCCAGCTCCCAGG	AT%
AGCACCCCACTCTACCCACCTGG	AT%
CTGCTGGTCCCAGGGCGATAGGG	AT%
GGGCCCTGCTTTTTGTGGCAAGG	AT%
GGCTCGGCGGTCCGCGCCAAGGG	AT%
GACGGTGGGCACGCCAGACTCGG	AT%
GAGGATCTCTCGGATGCGGCTGG	AT%
CGGCCCCTCCCGTTGGCAATGGG	AT%
CATTCAGCTCTCCCTTCCCTGGG	Secondary structure or energy
CTATGCCCCAGGGTGAGTGGGGG	AT%
GCGTGTGCCAGGACCTTCCAGGG	AT%
GGACACCCAACCCCTGGAGGCGG	AT%
CAATCAGCACTGCTGGTCCCAGG	AT%
ATGGAAGTCGCCCAGCTCCCTGG	AT%
AGCCTGTGAAGTGAAGCCTTGGG	Secondary structure or energy
GATGAGATCCACAGCCCGCTTGG	AT%
AGAGGTGGTTGGCCTTCATGAGG	Secondary structure or energy
AGCCCTTCCTGGGGGGCTCTGGG	AT%
GAGTGATGGGTTGGCTACTCTGG	Secondary structure or energy
AGGCTTTGTTGGTAGGGGCTAGG	Secondary structure or energy
GTCCCCAGGAAAGGCCTGTGAGG	AT%
GGTGTCAATCTGAACTGGAACGG	Secondary structure or energy
CTGTGGGTGGAGCTCACGGTTGG	AT%
CCTCCATGACCACATAGGGCAGG	Multiple matches in exons
AGTAGGGCTGGGTCAGGTAGAGG	AT%
GCCTGGCGTGCGCTGCCCCGCGG	AT%
CCTCACCTCCTATTATTGCTTGG	Multiple matches in exons
CCTGCTTTTCCCAGACATCTTGG	Multiple matches in exons
GCACGAAGCGGGTGCAGGTCGGG	AT%
CCGGCCCCTCCCGTTGGCAATGG	Multiple matches in exons
CCTCATCGGCCACCACGGTGCGG	Multiple matches in exons
AAAGTGGTAGGGGCATGATGGGG	Secondary structure or energy
CATCTGGCTGAGCATGCGTGGGG	AT%
CCGCGCTGTTGCGCATGGGCCGG	Multiple matches in exons
GAGACCGCCGTTCGCGCGCAGGG	AT%
GCCAGGCCAGTGGGCAGAGGTGG	AT%
GAGCTTGTGCTGCGGGTCTGGGG	AT%
CAGAGCCAGCCTGAGGCCCACGG	AT%
CTGAGCTGCCAGTTGACTTGAGG	Secondary structure or energy
GAAAGCCTGAGTGGGGCCAAGGG	AT%
CCTTATGGGAGAACAGAACGAGG	Multiple matches in exons
GGTAGTCAGGCCCAGTGGCCAGG	AT%
GTGGCGTCTGGCCGGGCACTGGG	AT%
GGGAAGACAGCCGGGTTCACTGG	AT%
CCGGCCCCATGGCAGCATAAGGG	Multiple matches in exons
GCAGTGGGGCCATCTGGCCAGGG	AT%
GGGAGGGGCCGGGGACTCAGGGG	AT%
GAGCGAGCGTGAGGAGAGCCTGG	AT%
CCTCTCTCTCTCTTCTTCCAGGG	Multiple matches in exons
CGGCTGGGCCCTGGACACTGAGG	AT%
AGACAGGCTGCCCCAGCAGGGGG	AT%
CACCACGCAAGCAGAGGAAGCGG	AT%
CAGGGAGTCTGTGGGGAACAAGG	AT%
GGAACATGGAAATGGGGGGGAGG	AT%
GCCCTCGGACCCGCCCCCGGGGG	AT%
CTTCCAGGGGAAGCAACAGCTGG	AT%
CCATGGTAGCACAGGAGCAATGG	Multiple matches in exons
CCAGCACTGGGCCTGGGGAGAGG	Multiple matches in exons
AAGGCACAACTACCGGAGGGTGG	AT%
GTACACACTCACACACGCTCCGG	Secondary structure or energy
AACTGGCAGGCCAGCTGCCCTGG	AT%
ATGGGCACAGCCAGGGTGGCTGG	AT%
CACAGCCTCTGCAGGGAGTTGGG	AT%
GAGCCCGCTGGAGCCGGGAATGG	AT%
CCAGGGTTCTGCAGGAAGAAAGG	Multiple matches in exons
GGCGCTGCAATCGCTGCAGATGG	AT%
GTCCAGCACCGCATTGCGTTTGG	AT%
ATGCCCATGGTCACGGGCCCCGG	AT%
CGCTGGTAAGGGAGTTGACGAGG	AT%
GCTGGGTGTAACCCCAGGAAAGG	AT%
GGGCAGCCTGTCTGCCCGCCTGG	AT%
CCTCTGTCAGGGTAGGTCTGGGG	Multiple matches in exons
ACAGCACAGAGGGGGCTAGAGGG	AT%
CGCAAGGAGCCAGAACCCAAGGG	AT%
GGACATCCAGAAGCTGCCGACGG	AT%
AGGACAGGCCAGCGCATGGCTGG	AT%
GTTGGGTGACAGCCAGAGGGAGG	AT%
GCCCAGAAGGTGGGTGCTCCAGG	AT%
CGTTTCTTCTTGCCATACTGTGG	Secondary structure or energy
AGGAGCTGCTCTTGCTGTCCAGG	AT%
ACAGGGTAGTGAGGTGGGGGAGG	AT%
AGGGGACTCCCAGCTCAGCTGGG	AT%
CGGGCCCCGTCGGGGCGGCCAGG	AT%
GCGGGCCACAGTAGAGCGAATGG	AT%
CTGGGGACAGTGTGTGTGTGGGG	AT%
CAGCAAGAGCAGCTCCTTCCAGG	AT%
CTGGAAGCTGACAGCCTAGCAGG	AT%
CCTCTAACCGGTGCCTGTGAAGG	Multiple matches in exons
CAGCCAGGTTTTAAGAGGTCTGG	TTTT
ACCCTGGGTGCTCTGGGTCATGG	AT%
AGGACATGATCGCTCGTCCCCGG	AT%
GACCCAGCTCCTGCAGGACGCGG	AT%
CTGTGAAGCCACAGGCTCAATGG	Secondary structure or energy
GTCCATCCCTCTGAACAAGGTGG	Secondary structure or energy
ACGATGATGGAGTTGGCAGAGGG	Secondary structure or energy
GCTCTACGTGCGCCTGGGTAAGG	AT%
GAAGGGAGGTAACCAGGGAGAGG	AT%
GTGAAGAGACAGATTGGCTCTGG	Secondary structure or energy
GACCGTGGCAAAAGCGTGAGTGG	AT%
GGGTTGCGGGGCTCCTCTGCGGG	AT%
CTGTGCCAGTGGTCAGGGTCTGG	AT%
ACCTTAGCAGGCCTCCTGGTGGG	AT%
AGCTACGGCCTTCCTGCCACAGG	AT%
GCCGCAGGTGGCAGTGAGGGTGG	AT%
AGTCCTGTGGTCCCCTTTCCTGG	AT%
AGGGGCTGCTCTAGGGTGGCTGG	AT%
AGACTGAGACTTGCTCCTACAGG	Secondary structure or energy
AGAAGGTCTGCATCTGGGTCAGG	Secondary structure or energy
CCTCCCTGGCTGAGCCCTCGGGG	Multiple matches in exons
CTCCGGTGCCCTCCTGTATGTGG	AT%
CTTGGGGCAGGAGGCCCTAGAGG	AT%
ACGTGCAGGAGGTAGGGACAAGG	AT%
CCTCCTGCACTGTGAAGTCAAGG	Multiple matches in exons
CAGGACAGTGACAGCCTCAGTGG	AT%
ATGACGCTCATAAAGGGGGTGGG	Secondary structure or energy
CATGCTGGTGGTGGCCCTCCAGG	AT%
GGGGACTCCCAGCTCAGCTGGGG	AT%
CCTCCATCCTGGGCTCCCCAAGG	Multiple matches in exons
GCGAGATGCTCATGGTGAGAAGG	Secondary structure or energy
AGGCTTTCAGCTGGTGCCACTGG	AT%
AGAGGCTCTGTGGGGTAGGGTGG	AT%
AGAGCTTGTGCTGCGGGTCTGGG	AT%
GCAGTACCCTGAGAACTGGCAGG	AT%
CCGCTGCAGGGCATGGGGCCGGG	Multiple matches in exons
ACAGAGCTCTGCATGAAGTAGGG	Secondary structure or energy
GGAGGCAGGCAACGTGCAGAAGG	AT%
GGGCCCCAAAAAGGGGATCTAGG	AT%
GCCAAGTTGGGGAGAAGTCTTGG	Secondary structure or energy
CTCAGCCGCAACGACGTCATCGG	AT%
ATGGTTATTCAGCTCACTGAGGG	Secondary structure or energy
CCCCTGATCCACCAGCAGCAGGG	Multiple matches in exons
GGCCAGGACCCATGAAGATAAGG	Secondary structure or energy
GCCGTCCTCCGGGCACCCTCGGG	AT%
ATGGACATCGGGGGCACATCAGG	AT%
GCCTTCTCGATCCAGCCCCTTGG	AT%
CGTGGACTCTGCGATGCCCATGG	AT%
CAACAGCATGGAGCTGAGTAAGG	Secondary structure or energy
CTCCATGCTGTTGCAGCAGCTGG	AT%
CCCCACGGGCCTCAGCAGCCAGG	Multiple matches in exons
CTTCCAGGTTGCCTGCAGGAGGG	AT%
CGGGTGCCAGGGTGGAGTCTGGG	AT%
CCCTGGACAATCCTGCCATAGGG	Multiple matches in exons
AGCCCCTCCATGACCACATAGGG	Secondary structure or energy
GCCCCTACCCATCTTCCGCTGGG	AT%
GCAGGAGCTGGGTCTGAACCAGG	AT%
GGACCCAGCACTGACCTCCTTGG	AT%
AGACTTTGCCAGCCTTTGCCAGG	Secondary structure or energy
CATAGCCCCCGTTTTCTTTAAGG	TTTT
CATTCCATTGGAAGGAAATAGGG	Secondary structure or energy
GGCGAAAGACTCATTGAAGATGG	Secondary structure or energy
ACCAAGTGCAACCATTGAAGAGG	Secondary structure or energy
CTGCCAGCTGCAGAGGGGACAGG	AT%
GGTGGGCAAATAGCCCTCCAGGG	AT%
GCGGTCGCAGTGGCCGCGGCGGG	AT%
CCAGTTTGCGCTGACACCAGTGG	Multiple matches in exons
CCTGGAGCCAAAGCAGGAGTTGG	Multiple matches in exons
GTTGTTAAGAGTGAACCCTGTGG	Secondary structure or energy
CAGGTTGCCTGCAGGAGGGAAGG	AT%
CCTCCTTACCCCGGGTGGCAGGG	Multiple matches in exons
AGTGACTGGGTTGTGGTCGTAGG	Secondary structure or energy
GGGGCGAATCGGGGTCGTGCAGG	AT%
AAGCAAAGACTGGGGGAGCGGGG	AT%
GAAGAGGCTGGGGGAGCAGGTGG	AT%
AGTAGCGCGTTTGGCGGAGCTGG	AT%
GGGCCATGGCGCCCAGGGGATGG	AT%
GACAGCAGCAGAAGCTCTACGGG	Secondary structure or energy
GTCGGGAGCCATAGCAAGCTTGG	AT%
GAGTGAGCCAGAGAAGTCCAGGG	Secondary structure or energy
CCCTGGCCTCTGGTGCTGGAGGG	Multiple matches in exons
ATGTTGCAGCCATCCAGCTTGGG	Secondary structure or energy
GATGACTTTAGGTCTGACCTGGG	Secondary structure or energy
GAGCCAGAGGCCACGCAAGCCGG	AT%
CAAGGCTGGGGGTCCGACTGGGG	AT%
GCAACTAGTAGCGAACAGCCAGG	Secondary structure or energy
CCCGAACTCATCTTCACATATGG	Multiple matches in exons
AAGTCCTGCGAGGAGGATAGAGG	Secondary structure or energy
ACTACTTCTAAAGGTCTCTCTGG	Secondary structure or energy
AGTGCAGAGCCCCTCTCTCTTGG	AT%
GGCCTGGGCTCACACTTTGTAGG	AT%
CAAGGGCTTCAACTTTTCCGTGG	TTTT
GTTGTTGTTGCAGTTGAGTGGGG	Secondary structure or energy
GGCTCAGTTTGAGCCCAACCTGG	AT%
GCCTGCATACACCTTTTAAAAGG	TTTT
CCAGGGTCCTCCAGGATCAAGGG	Multiple matches in exons
ACATCCAGTGGAGCAGGTGCCGG	AT%
GGGAGGCATTTGGCCCTGGAAGG	AT%
CGTGTACATCGGCATGCTGGGGG	AT%
GAGCAGCAGACGATGGGGCAGGG	AT%
CTGCAGCAGGCTCAGGAGGCTGG	AT%
GCCGCGGCATGGTGGGGAAGAGG	AT%
AAAGTGGTGATCAGTATCCGGGG	Secondary structure or energy
CCTCAAAGCCATGGACATCGGGG	Multiple matches in exons
CTCTGCAGCTGCGCAAAGTCGGG	AT%
CAGCGGCAGGGCGGGGCCGGTGG	AT%
GCGGCCAGGAGAGGGACCGTCGG	AT%
CTCAGGGTCTCCGTGGGATTTGG	AT%
CAGGTTTGTAATCCTGTCTGTGG	Secondary structure or energy
GAGGAGCCCAGCCTGGACCGTGG	AT%
CTGGGCCACATGGTTCCACCTGG	AT%
ACCCTCCGGTAGTTGTGCCTTGG	AT%
CTGGCTGGTGCAGAGATCTCAGG	AT%
GCTCTGAGCCAGAAGCTGAAAGG	Secondary structure or energy
ACCCCAGGGGGCTGGCCAGCAGG	AT%
CTCTCCACCCTGGGTGCTCTGGG	AT%
GAGGTCCTCAGTGTGAGTTGGGG	Secondary structure or energy
GAAACCAGTCTACTGCTTGCAGG	Too close to reverse primer
CATTGCCAACGGGAGGGGCCGGG	AT%
GCGACCGCCACCTCCATCCTGGG	AT%
CCAGCCCTTTCCCCAGGCTGGGG	Multiple matches in exons
CAGCCAGACCTTGCAAACAGTGG	Secondary structure or energy
AGTGAGCGGGCAGCTCCAGCAGG	AT%
CTCGGGAGTGAGGTCTACCTCGG	AT%
GGGTCTCCCCTCACCATGGCAGG	AT%
ATGCCCACCCTTCTAGGGTCAGG	AT%
GATGGGTATGTCCATGGAGATGG	Secondary structure or energy
GGGAGCCAGGCCTTGGCCCTTGG	AT%
CGGCCCATGCGCAACAGCGCGGG	AT%
CCTGGCACAACTCCCTGCCCAGG	Multiple matches in exons
CATCATAGCCCACTGGGAACTGG	Too close to reverse primer
CTGCAGCTGAGCCGATGTTCTGG	AT%
ACACTGAGCAGCATCCCGGGGGG	AT%
GCTGCCTAGAGCCGCCTCCAGGG	AT%
CGCTATCCGCCGTCACTTCCTGG	AT%
GGCAGGGCTGGCTGGAGCACAGG	AT%
CCTCCCACACCCAAGAGGAGTGG	Multiple matches in exons
GGGGTGGGGGCTACAGAGACAGG	AT%
GTCCAGGCTGGGCTCCTCTGGGG	AT%
GAGCTAGCCCTGAGGTAGTCAGG	AT%
CCAGACTTCCTGGCAACTTCAGG	Multiple matches in exons
ACTCACCAGGTCTCGCCCAAAGG	AT%
CTGGCCAGAGGCAGGGCATAGGG	AT%
GCTTTCCATGACGATGATGTGGG	Secondary structure or energy
CTCAGGGCCCAGTAGCTTTGGGG	AT%
CCTTCCCCAGGGCGAAGAAGAGG	Multiple matches in exons
GGGCAGGTGCTCATGCAGCATGG	AT%
CACCCTCACACAGCACAGAGGGG	AT%
CACGAAGCGGGTGCAGGTCGGGG	AT%
GGCTGGCCGCCTCCGGGTCCCGG	AT%
GTGCCGGGTGTTCCTCACCCTGG	AT%
CCTTACCAGCGAGATGCTCATGG	Multiple matches in exons
GAGGAAGCGGGGAGCATTCCAGG	AT%
CCAGCCACTTGTCGCCTGGTAGG	Multiple matches in exons
CCGCAGCGGCAGGGCGGGGCCGG	Multiple matches in exons
CTTCCTGGGCGATGACACCTGGG	AT%
GGGGCAAGGGGTGGGGATCGGGG	AT%
GCGCAGTGAGAGGCGCGCCGAGG	AT%
CCTGAGGCAGTGCCACAGCCGGG	Multiple matches in exons
AGCTTGGGCCTAGGGAAAGAGGG	Secondary structure or energy
GAGTTTCGTGAGGATGAAGTAGG	Secondary structure or energy
CCAGGACCCATGAAGATAAGGGG	Multiple matches in exons
ACAGGGAACCACCCCTTCCAGGG	AT%
CCTAGAAAGGGTGTACCGGGAGG	Multiple matches in exons
CCGGGCCTTTGATGATGAGGAGG	Multiple matches in exons
GCCGGGCCAGGGGTCGGCACCGG	AT%
CTACTGGGGAATTGTGGGGGTGG	AT%
AGAACATCACTTGGAGGCACAGG	Too close to reverse primer
ACTCCTCCCGACCTGCCAAGGGG	AT%
GTAGGACGGGATGGAGAGGCTGG	AT%
GCGCGCAGGCCAGAGGGAGGAGG	AT%
GCAATGTCGTCCCTTGGGCCTGG	AT%
CTGAGGGACGGGTTCTCCTCGGG	AT%
GTGCAGTGCCAGCTCTCCCCGGG	AT%
GCTCTCCCCTCCCTCAAGTTTGG	AT%
GCCGCCCATACAGAGGAGTCAGG	AT%
GATGCGGTGAGGGACCAGGCTGG	AT%
ATCCAGGCCAAGTCCTGCAGAGG	AT%
CTGGACTCCAAGGGAGGTCTTGG	AT%
GCAGCCCCTTTCTGAAGATGTGG	Secondary structure or energy
GTGTGCCAGAAGGTGCTTGCAGG	AT%
GCTTGCTATGGCTCCCGACCCGG	AT%
ACGGGCCCACCTCTGCCCACTGG	AT%
CGCTGCAGATGGGCGACAACCGG	AT%
GTGGTGGTGGGCCTGGCAGGTGG	AT%
GCCGCAGCCCCGCTACAGCCTGG	AT%
CTTCCCTCCTGCAGGCAACCTGG	AT%
CCTGGCAGGTGGGCTGGAGGTGG	Multiple matches in exons
ACAGTGGGCACCTTCACAGCGGG	AT%
GCACCAGAACACCACATCTATGG	Secondary structure or energy
CTCCACCATCTGAGCCCCCCTGG	AT%
GTTGGCTGCAAAACAAACAAGGG	Secondary structure or energy
GGTCCAGTACTTCTGGCTCCAGG	AT%
ACGTGGATGATGCGGCCAGGTGG	AT%
CTGGTGCAGGTTCCAGGGCAGGG	AT%
CTCACCCTGGGCCTCCTCCCAGG	AT%
GGGTACCAAACTTGAGGGAGGGG	Secondary structure or energy
GTTAAGGGGTAGAGGGGAAAGGG	Secondary structure or energy
GCACGCCAGACTCGGGGCGTGGG	AT%
CCCACATACTTTGCCATCTGGGG	Multiple matches in exons
GATGTGCTGCAGAACGAGGAGGG	Secondary structure or energy
CCGGAGCGCACGCGGCGGGCAGG	Multiple matches in exons
AAGATTGACCCTACAGAGAATGG	Secondary structure or energy
GGCTCGGAGGCTGTCCCTGGTGG	AT%
CGCCCCTAAGCCCTTCCTGGGGG	AT%
GGCTGGGATGGAGGAGGAGGTGG	AT%
CATGCTGGTGGTTGTAGGGCAGG	AT%
AGCACGAGGCCAGTTAGGAAAGG	Secondary structure or energy
GGGCATGCTACCTTCCCACATGG	AT%
CTTCAGGGCCCTGAAGTCCTCGG	AT%
GCAGACGACCATTCCTGTGGCGG	AT%
AGGGGTAGAGGGGAAAGGGCAGG	AT%
CCAAGATGTCTGGGAAAAGCAGG	Multiple matches in exons
AGTGGGCAGAGGTGGGCCCGTGG	AT%
CCCTATGGCAGGATTGTCCAGGG	Multiple matches in exons
CTTGGCAGGTTAGGAGGAGCAGG	AT%
CCCGGAGGCCGTAGCGCACGGGG	Multiple matches in exons
AGCCCCCCAGGAAGGGCTTAGGG	AT%
CGCCCTCACAGGCCTTTCCTGGG	AT%
CCACACCCAAGAGGAGTGGTGGG	Multiple matches in exons
GGGACCACAGGACTGGCCAGAGG	AT%
GGCGACACAGGCCGTCGGGCAGG	AT%
CTGGGAAGCCATGTAGGCACAGG	AT%
ACATGCAGGCTCTTTATGTCCGG	Secondary structure or energy
CCAGCTGCCCTGGACAGAGCAGG	Multiple matches in exons
AGGGCTTTTCCGCCCACTGGTGG	AT%
CGCAGCTCCTCGATCTCCTCGGG	AT%
GTTCAGATGCTCTGAAGACCTGG	Secondary structure or energy
GCACACAGGCAGGCCGGGGCGGG	AT%
AAGGGATTCCTCCAGGTCCCTGG	AT%
CTGGGCCTGGGGAGAGGGGTAGG	AT%
CCCAGGGCCCAGAGCTGCCTAGG	Multiple matches in exons
CAGGAAGGTTAGAAACACTAAGG	Secondary structure or energy
GACCAGGTCATCCTGCTTGGTGG	AT%
GGAGGTGTCGGGGCAAGGGGTGG	AT%
CCCAAGCCTGTAACACAGTATGG	Multiple matches in exons
GCCAGCCATGCCCGGGATCGTGG	AT%
GCTTGGTGGGGCTGGCCCCGTGG	AT%
ACGGGAGGGGCCGGGGACTCAGG	AT%
GCTGGGTGTGATGGAGCTCGGGG	AT%
ATGGCTCAGTCCTGGGCATAGGG	Secondary structure or energy
CCCAGCTGGCCAGCTGGTGGAGG	Multiple matches in exons
GTAGCCATGGGGGTAGCTTCAGG	AT%
GCATCTATAACTTTCACTTGGGG	Secondary structure or energy
CTCTCAGCTTGACGAAGGTGCGG	Secondary structure or energy
GGGTGGTGGCAGCGGCGTCCCGG	AT%
GGTGGGGGGTATGTCCCTGATGG	AT%
GGGTGGAGTCCATGAGGGTATGG	AT%
CGGACCCCGGTACGTGACCAAGG	AT%
CCACGTGGCATAGAGTCTCCGGG	Multiple matches in exons
CCTCCTCGCAGGACTTGCTGTGG	Multiple matches in exons
CCTTTAGAAGTAGTGCATCTGGG	Multiple matches in exons
CCGGGCCGCTCCGGCCTCGGGGG	Multiple matches in exons
CAGCTCACGCACAGAGCTGCTGG	AT%
CCCATTCCCTCTGCAGGACTTGG	Multiple matches in exons
GGCCTCCTCCCAGGAAGTGGAGG	AT%
CCCTCAGTGTAGTCACTAGTGGG	Multiple matches in exons
CATTCCTAACCCCTCGCCCAGGG	AT%
CCTTTCTTCCTGCAGAACCCTGG	Multiple matches in exons
CCACATCTATGGTAGCAGTTGGG	Multiple matches in exons
GTTTTCAGACCAAGAAGTCTGGG	TTTT
CAGGATTGGCCTTTCCCAGCTGG	AT%
GGACCATCCCCTGGGCGCCATGG	AT%
CCAGGCCTTTGGGCGAGACCTGG	Multiple matches in exons
CCTGGATGGAGGACCTGGAGAGG	Multiple matches in exons
CTGGAAGTATAGAGGCAGCAAGG	Secondary structure or energy
GGCAGGTGGAGGGGTGTGCTGGG	AT%
ACTCAGGTATGGATGTTTTGGGG	TTTT
CGACGAAGGGGACCATGTACCGG	AT%
CTTGGTACAACAGAGCTCACTGG	Secondary structure or energy
CTGGCACAGGGCCTCTACCCTGG	AT%
CTTCTAGGAAGCTCACAAGATGG	Secondary structure or energy
ATGCGCACGTGTGGGAAAGGGGG	AT%
GCCCTTTCGGGGTCCAGCTTTGG	AT%
GAAGGCTGTGAGCAGGGGCTTGG	AT%
GGGCTGCCAGTGTGTAGTTCTGG	AT%
CAGACCCTGACCACTGGCACAGG	AT%
GGCTGAAACGGTCATAATCCAGG	Secondary structure or energy
AGAGGGATGTGCTGCAGCCGAGG	AT%
CCAGCAGTGCTGATTGGCTATGG	Multiple matches in exons
GCTTCTCTGCCGCCGCTGCAGGG	AT%
GGGGCCAAGGGAGGCTCCAAGGG	AT%
ATCCGGACTTCCACCCCCACAGG	AT%
GAGTGGGGTGCCGTAGGTCGGGG	AT%
GCAGAGGGTTCATGGGAGCCTGG	AT%
GACCCCCGGGGGCGGGTCCGAGG	AT%
CCCTGTGGCCTCCTTGCCTAGGG	Multiple matches in exons
GCAAAGAGCCTGGGGGGCTTGGG	AT%
CCAGCCGGCACCTGAAGCTGGGG	Multiple matches in exons
AAGGCGTTCTGCGCCAAGCACGG	AT%
CCCTCTCTTGACCCTGTGGCAGG	Multiple matches in exons
CTGGGTGCCGCTGTGCCCAGCGG	AT%
CTGGGGGTAGAAGGCGAGCCAGG	AT%
CCGGGACTGGTTCAGCAGCCAGG	Multiple matches in exons
GCACTCAGGTATGGATGTTTTGG	TTTT
CAGGACACCCAGGTAGGGGTAGG	AT%
GCTGACAGCCAGCCTGTTTGAGG	AT%
CCCAAGACTTCTCCCCAACTTGG	Multiple matches in exons
CCTGCCACTCCCTGGCTTCCTGG	Multiple matches in exons
GGCCCCGTGGCCTGTGGGGGTGG	AT%
AGATGGGCAGATCCCTCCAGAGG	AT%
CCTCTTACTTGGGGCAGTGAAGG	Multiple matches in exons
AAATGGTCCCAGCGGCACCCGGG	AT%
CCGCCCATTGCCAACGGGAGGGG	Multiple matches in exons
GTGGCACACTTTAGGAAGAAAGG	Secondary structure or energy
CTGATGCGGCTGCCATTTGATGG	Secondary structure or energy
GCATTCCTAACCCCTCGCCCAGG	AT%
GGAGCCAGTTCTCTGGAACGGGG	AT%
GAGGCAGTCCATGTCCTCCGTGG	AT%
GGATCTGCTGAACCCTCCTCTGG	AT%
CAGCTTCTCCCAGCAGCCAGAGG	AT%
AAACTCCTCCCGACCTGCCAAGG	AT%
GCACCTACTCACCGTGTGCATGG	AT%
GGGAGCCCGGAGGGGGACCCGGG	AT%
ACCTAGGGGGTCAAGGCAGGAGG	AT%
CTCCCTGTGGAGGGACACAGAGG	AT%
CCCAGACATCTTGGTTCTGGGGG	Multiple matches in exons
ACAGGGAGTGGAGAGAGGGTGGG	AT%
GCCGGGGCGGGGGGCCCCCGAGG	AT%
CTGGAGGAGCTTCCAAGGCTCGG	AT%
CCCTCCCTGGCTGAGCCCTCGGG	Multiple matches in exons
GCAGCTGCTGGTCCCAGATGTGG	AT%
GTGGTTGTTAGGTACCCACAAGG	Secondary structure or energy
GCCGCTGCGCAGCTGCTCCTCGG	AT%
CTTGAGTACATAACTCCCCCCGG	Secondary structure or energy
CCCTATGCCCCAGGGTGAGTGGG	Multiple matches in exons
GGGAGGGGGGAGGTTGTGCATGG	AT%
CTCTGTGTCCCTCCACAGGGAGG	AT%
GGAGGACTGTCGGAGCTGTGTGG	AT%
GCAGGATGACCTGGTCATCTCGG	Secondary structure or energy
AAGAGAAGCTGGCCCTCCTGAGG	AT%
CTACGGATAAGTGATGGCCCTGG	Secondary structure or energy
CCGGTCGTGATCAATGTGCATGG	Multiple matches in exons
CTTGGTCTATAACCCACACGAGG	Secondary structure or energy
ACTCAGGGCCCAGTAGCTTTGGG	Secondary structure or energy
CGGCGGGCCGAGCCCTGCGGCGG	AT%
CAGGCTCAGCACATATAGTGTGG	Secondary structure or energy
GCAAGCTCTCAGGTAGGAACTGG	Secondary structure or energy
ATGCTCCTCCCACACCCAAGAGG	AT%
CCTGCAGTGGGGCACACAACAGG	Multiple matches in exons
GTGTGGGCATCAACACCGACCGG	AT%
AAGTTTGGTGAGAGAGGAGAGGG	Secondary structure or energy
CGGGCTGCGCGAGCTTCCCGAGG	AT%
CCTCAGTCCTCAGCATTTTCTGG	Multiple matches in exons
GCCCTGCTGCTGGTGGATCAGGG	AT%
ACTTCCAGGTTGCCTGCAGGAGG	AT%
GTAGTTGTGCCTTGGCATCGTGG	Secondary structure or energy
ATTACATGCAGGTTCCTGGAAGG	Secondary structure or energy
CCCCGCTACAGCCTGGCCCGGGG	Multiple matches in exons
GTCTGTCCCGCTGGCCGCCCTGG	AT%
GTTTGGTACCCAGAAGGCAAGGG	Secondary structure or energy
CTCGGTGGTGTCCACCTACCAGG	AT%
ACATCAGCCGCTGGGCACAGCGG	AT%
CTGGCCGCCCCGACGGGGCCCGG	AT%
GATAAAGCCGGGAGCGAGGCTGG	AT%
GCTCATGGTGAGAAGGGTTGGGG	Secondary structure or energy
ATAGCTCCCTGAAGGAGTCAGGG	Secondary structure or energy
CAGACCCCCCAGATGTGGCATGG	AT%
ATTTGCTGATACTAAAGACGTGG	Secondary structure or energy
AGGTGGAGGTGTCGGGGCAAGGG	AT%
GTTTAGGGGGCCTCTTTTTGTGG	TTTT
AAAAGGACTGTCTTGGGGACAGG	Too close to reverse primer
ACCAGGCGCAACAACGGCCGCGG	AT%
GCCACCATCACCTGACCTAGGGG	AT%
GGCCCCATGGCAGCATAAGGGGG	AT%
GTCAAGTACCTAGCTGGCCCTGG	AT%
CAAAGGCCCGGGTTGGACGCCGG	AT%
ACTGCGGGCCACCTTGGTGGGGG	AT%
GCTGCCCGAGGATCAGGTGGAGG	AT%
CTCCCCTGGTGGCACACTTTAGG	AT%
CCACTGGGAACTGGGCTCGGGGG	Multiple matches in exons
CAGGGTGGCTGGCACGGCATGGG	AT%
GCAATCTTGGGGAGCGGAGGGGG	AT%
CGCCGGCGATGCCGCGCCCCCGG	AT%
CACAGGGCTTTTCCGCCCACTGG	AT%
GTCCGTAGGCCCTGGCCAGATGG	AT%
ACACGTGCGCATGAGCTTCCAGG	AT%
GGCCCAGAAGAGGAAGGCCGAGG	AT%
GGGGGCCCCCGAGGCCGGAGCGG	AT%
GTAGCGCGTTTGGCGGAGCTGGG	AT%
CCTGGGGTCAAGGACAGTGGAGG	Multiple matches in exons
CCGCTGGAGCCGGGAATGGCCGG	Multiple matches in exons
ACAGCTTGGTAGGAACTTTCTGG	Secondary structure or energy
GCTGACTGGCTAAGAGGTGCAGG	AT%
GCCGTGGTCCACCAGGTTCAGGG	AT%
GGGTCGGGTACTGGGGGCGCAGG	AT%
CCATCATGATGTGTGAGGCAGGG	Multiple matches in exons
GCCTGTCCTCCCAGGGAGCTGGG	AT%
CAAACACCTGCTGAGCCTCATGG	Too close to reverse primer
CGGGAGGGGCCGGGGACTCAGGG	AT%
GCCCTCACAGGCCTTTCCTGGGG	AT%
CGGCACCCCTGCCATGGTGAGGG	AT%
AAGGGAGGCTCCAAGGGCCAAGG	AT%
GGAGGGACTTGAGGGTGAGGAGG	AT%
CCTCCCTGCCTGACCCTAGAAGG	Multiple matches in exons
GTGTAGCACCTGGGTCTGCTGGG	AT%
CTCAGAGCGTATCATTGTGCGGG	Secondary structure or energy
CTGTTGCTGGAAGATGAGCTCGG	Secondary structure or energy
ATCTGTAGCAGGACTGGAGACGG	Secondary structure or energy
GGCGCAGGACCCAGGGCTCTGGG	AT%
AAGAAGAGAGAGAGAGGGCTGGG	Secondary structure or energy
CGCCCAGGTAGAGGCGCGTGAGG	AT%
ACCTGCACCCCCATGTGGGAAGG	AT%
CCATGCCGTGCCAGCCACCCTGG	Multiple matches in exons
GAGGCCGCAGGTGGCAGTGAGGG	AT%
GGTGACGGAGTAGAGGCACATGG	AT%
GGAACAGGGCCTCCTGGAGATGG	AT%
GACCCTGTAAGTGTGGGCTCAGG	AT%
AGTACTGCACAGAGGATGAAGGG	Secondary structure or energy
GCGGAGCCGCAAACCCAGGGCGG	AT%
CCCGCGGCTCGCAACACCGACGG	Multiple matches in exons
ATGCTCATGGTGAGAAGGGTTGG	Secondary structure or energy
AGCCCCATCCACCTAATCCCAGG	AT%
AGCCGCGGAGCCGGGGAGCGGGG	AT%
AGGGAGGTCTTGGCGATCTCAGG	AT%
GCTGGCGGATCTGCTCCCAGCGG	AT%
AATCTCCTCCCAACGGAAGGTGG	Secondary structure or energy
GAGTTGGTCAAATTTATGTGTGG	Secondary structure or energy
CACACAGGCAGGCCGGGGCGGGG	AT%
GCCGCGGAGCCGGGGAGCGGGGG	AT%
GAGTTGGGGCTTACGAACCCAGG	AT%
AGCGCTGCTGTCTGCTGCAAAGG	AT%
CAGGCAAAGTGGGTGCCAGGAGG	AT%
GGAGGAGAGCAGCAGACGATGGG	AT%
GGGGGAGTCACAGAGTCAGGGGG	AT%
AGGTGGGCAAATAGCCCTCCAGG	AT%
CTCCAGGGCCTGAGACCATTTGG	AT%
AGCTGGCAGAGACCACAGGTGGG	AT%
AGAGAGGGGCTCTGCACTCTAGG	AT%
AAGGTGGGGGTCCCTGGGCGAGG	AT%
CACGCTCCAGTACTGCATGGAGG	AT%
AGGAGCACAGCTTGCTGCTGAGG	AT%
GGATGTAGGACGGGATGGAGAGG	AT%
AGAGGCTCCCAGAGGCCAAATGG	AT%
ACAGGGTGCTGGAGAGCCACTGG	AT%
GGCAAGGCCGTGAATTCCCATGG	AT%
CTCACCTTCAGAGCACTTCGGGG	Secondary structure or energy
CCTCCCCCCAGCCTGGGGAAAGG	Multiple matches in exons
CTGCCCCATCACGAACTGCTGGG	AT%
ACTTCCTGGGAGGAGGCCCAGGG	AT%
ACCAGGAGTCTGTTGTGGGGTGG	AT%
GCTGGGCTCCCGGTACAGTCCGG	AT%
CTGCGGTCAGACTCATCGTGTGG	AT%
CATGGGGAAGGGAGGTAACCAGG	AT%
GGTCTCCCCTCACCATGGCAGGG	AT%
AGAGCCAGCCTGAGGCCCACGGG	AT%
GAGCCCCTCCATGACCACATAGG	AT%
ACTGTGGTACTTCTGGCCATCGG	Secondary structure or energy
CGAGCTTCCCGAGGAGATCGAGG	AT%
GTCCCAGAATACTCTACTTTTGG	TTTT
GGGAAGGTAGCATGCCCCCTTGG	AT%
CCAGAAACATAAGAGCATCGAGG	Multiple matches in exons
GGTGATAGAAGGGGTCAGGCGGG	AT%
AATTTACAAAAGCAGAGACTTGG	Secondary structure or energy
GGTGGGGTAGTCCCCACAGCTGG	AT%
CCATCCTGGCTGGGTTCCTCTGG	Multiple matches in exons
GTGCAGCCTGACATCGGAGGAGG	AT%
CTGGAGGCGGCTCTAGGCAGCGG	AT%
CCGGGCCAGGGGTCGGCACCGGG	Multiple matches in exons
GCCCAGCCGGGACTGTCGCGCGG	AT%
CCTTGGGAGAGCTAGCCCTGAGG	Multiple matches in exons
CTCTTGGTTCCCCAGGGCCGTGG	AT%
GGGCGGCCCGGAGGGCTGGCGGG	AT%
CTTCCACCCCCACAGGCCACGGG	AT%
GAGGCTTCCACCAGAGTGCCAGG	AT%
CTGGGTGTGATGGAGCTCGGGGG	AT%
GCTCTTGTTCCCCAAACCCCTGG	AT%
GGGCCGGCTGCTGTCCCCAGTGG	AT%
AGGTCTACAACGTTACCAAATGG	Secondary structure or energy
CCTGCGCTAGCAGCGAACTCAGG	Multiple matches in exons
AACTGGAGACCAAGGTGAAGCGG	Secondary structure or energy
CGCTCCCCGGCTCCGCGGCTCGG	AT%
AGAACCCGGGGAGAGCTGCAAGG	AT%
GCTCTGCTGCCAGTCGCTCCTGG	AT%
CCTCTGCACCACTTTCTCGTAGG	Multiple matches in exons
CCCCCTCCCGGCACACAGGCAGG	Multiple matches in exons
GGACGCCGGGCTGGCTGCCGCGG	AT%
GGCCAAAAGTAGAGTATTCTGGG	Secondary structure or energy
ACGCCAGGCTCGCGAACTAGGGG	AT%
CAGCAGCTGGTGTAGCACCTGGG	AT%
CCACAGCAAGTCCTGCGAGGAGG	Multiple matches in exons
GCCCACTGGGAACTGGGCTCGGG	AT%
CCGACGGAAACCTTCCAGCTGGG	Multiple matches in exons
AACTGAGGCCCAGGGAGTGTGGG	AT%
CAGCTCCAGGGCCAGGCCAGTGG	AT%
CACAGGCACCGGTTAGAGGAGGG	AT%
GATGGCTCAGTCCTGGGCATAGG	AT%
AGAGCTCAGGATGGGAGGCTTGG	AT%
AGAGACCAGCAGGACATCGCGGG	AT%
GCCTCAGAGCCTGAGTCTGGGGG	AT%
GGGTGCACCTGGCGGGTGCCAGG	AT%
CTTTAAGGCAGTGCCTGGAGTGG	Secondary structure or energy
CGGTACACCCTTTCTAGGAAGGG	Secondary structure or energy
CATCCTGGCTGGGTTCCTCTGGG	AT%
CCAGCGGGACAGACTGGCGGTGG	Multiple matches in exons
ACTGCTCAATGTTGATAGACTGG	Secondary structure or energy
CCCGCCCATTGCCAACGGGAGGG	Multiple matches in exons
CCCTACCCCACAGAGCCTCTAGG	Multiple matches in exons
AAAGCCATCAAGTAGGTGCCAGG	Too close to reverse primer
CCACCTGTTTTACATCGACCCGG	Multiple matches in exons
ACTTGGGGTTTGGATCGCCTAGG	Secondary structure or energy
GCAGCGAGCCAAACGCAATGCGG	AT%
CTTTCCAGTTAAGGACTGAGGGG	Secondary structure or energy
GGGTAGAGGCCCTGTGCCAGTGG	AT%
GGCAGTGTGCTGCAGGGGGCCGG	AT%
CCAGGAGAGCAAGTGGGCAGAGG	Multiple matches in exons
AGCTTCTTCTTGCCATACTGAGG	Secondary structure or energy
GGTGTAGCACCTGGGTCTGCTGG	AT%
CCCCGAGGGCTCAGCCAGGGAGG	Multiple matches in exons
CTGCGGTTAGTCGACTGGGCGGG	AT%
CCTGCTACAGATCCTGCCCTTGG	Multiple matches in exons
GTCAAGGACAGTGGAGGGGAAGG	AT%
CTGCTGAGCCCCACCAAAGCTGG	AT%
GAGCCTCTCCCCAAAGCTACTGG	AT%
GGGCCCCTCGGATGCCTTGGTGG	AT%
GCTGAGAAGAAGTGGGGACCAGG	AT%
CCGAGGGCTCAGCCAGGGAGGGG	Multiple matches in exons
GGCTCGGGGGGAATCCAACCTGG	AT%
AGCTGGAGCTGAGCGGGCGGCGG	AT%
GTCTAGTTATGGTCCCTGGAGGG	Secondary structure or energy
GGTTCAAAGCTGGGTTGCTCCGG	Secondary structure or energy
GCCCCCTCTGTGCTGTGTGAGGG	AT%
AGCGATGGCTCGTGATCGACCGG	AT%
CCACCTGGACTTAGTGAAGATGG	Multiple matches in exons
CCTGAAGCTGTGAAGGACACAGG	Multiple matches in exons
ATGCCCACCTGGCGGGCCTCTGG	AT%
GCATAGGCCTGAAAGTGGGAGGG	Secondary structure or energy
CCTGCATACACCTTTTAAAAGGG	Multiple matches in exons
CAGCAGCTGGATGGAGGTCAGGG	AT%
CCAGGTCCAGATGGAAGGCACGG	Multiple matches in exons
CCACCCCATGAGTCCAGCTCAGG	Multiple matches in exons
GGAGAGCTGGCACTGCACAATGG	AT%
GGATTTCTAAGCTTTAAGTGTGG	Secondary structure or energy
GTCTGCACCTATTCTGAAGAAGG	Secondary structure or energy
GCCCGCGCGACAGTCCCGGCTGG	AT%
GAGTTGCTACTGGGGAATTGTGG	Secondary structure or energy
GAAGTGGGGACCAGGGCAAATGG	AT%
GCCCAGCCTCCCTGCTCTAGTGG	AT%
AGCTCTTGATGTCATTCTCACGG	Secondary structure or energy
CATCAAGAAGAAGTTGGAGCAGG	Secondary structure or energy
GCCCTGTTCCTGAAGTTGCCAGG	AT%
CTACCTCTTGGGCCCTGGCTGGG	AT%
GGAGGAGGAGCCCTGTGAGGAGG	AT%
GGGGACCCGGGCCGCGGGAGGGG	AT%
CCTGCCTCACACATCATGATGGG	Multiple matches in exons
CAGTGACGTGCTGTGGCAACGGG	AT%
CACCAGACAACCTCCAGCTACGG	Secondary structure or energy
CTGCACAGTACCACGGACACAGG	AT%
CCGCAGGGCTCGGCCCGCCGCGG	Multiple matches in exons
GCACCAAAGACCAAGGTGCTCGG	Secondary structure or energy
GCAACTGCAGCAGGCTCAGGAGG	AT%
CTCTTGACCCTGTGGCAGGAAGG	AT%
CCCGCCCGCGCTGTTGCGCATGG	Multiple matches in exons
GGCCATAGTGTTTGGTTCCACGG	Secondary structure or energy
ATAAGGACTATTTCTTGAGCAGG	Secondary structure or energy
CAAAGTGCAGTGCGTGTTTGTGG	Secondary structure or energy
GGAGTGAGCCAGAGAAGTCCAGG	AT%
GATGGTGAGGCTGGACTCCAAGG	AT%
CAGAAGTTCGAGGGAGTCCTGGG	Secondary structure or energy
GAGCCCCTCTCTCTTGGGGCAGG	AT%
GGTTTCTTTTCAGGCCCGTGGGG	TTTT
CCATGCTTCCAAGGAGACAAGGG	Multiple matches in exons
ACCATCCTGCTGAGCAGTGCTGG	AT%
CCAAGTATAAAAGAGCTTAGGGG	Multiple matches in exons
GGCTGTCACTGTCCTGCAGGAGG	AT%
GGCCGGGCGACCCCCGGGGGCGG	AT%
GCCAAACCTACCTAGGAGGAAGG	Secondary structure or energy
CCCCACTAGTGACTACACTGAGG	Multiple matches in exons
CATGCCCATCAGGTGGCTGGTGG	AT%
ACAGAGCTCAGTGGGCAAGAGGG	Secondary structure or energy
CCCAGCTTACCTCCACAGGAAGG	Multiple matches in exons
GGGAGGCCCTCGTCTTGTTGGGG	AT%
CTGACTCACCCTGGCCCGGGAGG	AT%
CTCCTGGAGCACCCACCTTCTGG	AT%
CTTCCCTCCAGGCCTCCTGCAGG	AT%
CACGGGCCACCGGCCATTCCCGG	AT%
GTCACCTCTCCTCCACCAGCTGG	AT%
CTTGACGAAGGTGCGGCCCGTGG	AT%
GTGCGAGTTCTCCCACTCCGTGG	AT%
CCATCGCTCCTTCTCCCGCCCGG	Multiple matches in exons
GACAGTCCCGGCTGGGCTCCCGG	AT%
AATGATACGCTCTGAGATCTGGG	Secondary structure or energy
CGGGTGCCGCTGGGACCATTTGG	AT%
GGTTTTCACTCCTCCAGGTCAGG	TTTT
GAGTTCATCTACGCTATCGTGGG	Secondary structure or energy
CTTCGAAGGTGAGAGACCGCGGG	AT%
CCTCCGGGCACCCTCGGGAAAGG	Multiple matches in exons
GCTATCTGCCCTAACAGGTAAGG	Secondary structure or energy
GAGGCCCATTCGCTCTACTGTGG	AT%
CGCCACCAGTTCCCACCCCTGGG	AT%
GCAGGTAGATCTTGACAAAGGGG	Secondary structure or energy
CGAGGAGCTGAGTGGGAAGGAGG	AT%
CTGTGGTCCCCTTTCCTGGAGGG	AT%
CCATCACACCCAGCAGACCCAGG	Multiple matches in exons
GCTCAGATGGAACTCTTGGATGG	Secondary structure or energy
GCAGAGAAGCGCGCGGCCGCAGG	AT%
CCGCCCTCACAGGCCTTTCCTGG	Multiple matches in exons
GCAGCGATTGCAGCGCCACCAGG	AT%
GGAGTGAGGTCTACCTCGGTGGG	AT%
CCGTGTCATCGGACACTATTCGG	Multiple matches in exons
GGCGCGCCTCTCACTGCGCTTGG	AT%
GCCAGCAGGCACCAGATCTGGGG	AT%
GGTGTCGGGGAGCCCGGAGGGGG	AT%
ACACCCGGCACCTGCTCCACTGG	AT%
CCGGAGGGAGCCGGCGACGAAGG	Multiple matches in exons
AAACTGAGGCCCAGGGAGTGTGG	AT%
GAAGGGACGACAGCTTCTTTGGG	Secondary structure or energy
ATTCCAAGGAGGTCAGTGCTGGG	Secondary structure or energy
GAAAGCCAGCAGGACCAGGCGGG	AT%
GGTTTTCAGCACCCTTGGCGCGG	AT%
CCGCCACCCGGGGGGCTCCCGGG	Multiple matches in exons
AGCAGTGAAGAGCAGAGAGCTGG	Secondary structure or energy
CCAAGATCCTAGGACAGTGGTGG	Multiple matches in exons
GCAGCATAAGGGGGTACAGGGGG	AT%
GGCACGGAGAGCTGGACCCGAGG	AT%
GCCCCACTCAGGCTTTCAGCTGG	AT%
ATGGCCTCTCACATTCTTGGTGG	Secondary structure or energy
CCATGAAAAGCATCGGGACTGGG	Multiple matches in exons
GCCTCCCTGCTCTAGTGGCTGGG	AT%
CCTGGGGAGGGTGCACCTGGCGG	Multiple matches in exons
GTCTCCTTCCAGGTCCTGGCAGG	AT%
CCACAGGAAGGACCTTCCCCAGG	Multiple matches in exons
CAGGTAGAGGTCAAGGCCACAGG	AT%
AACACGATTCATACCTCAAGGGG	Secondary structure or energy
GGGAGGTACCCAGACGCGATGGG	AT%
GATCCACCAGCAGCAGGGCAAGG	AT%
ACTGCCCCGAAGTGCTCTGAAGG	AT%
CAGTGTTGGGGATTGACCCCAGG	AT%
CCCAGCTGGAAGGTTTCCGTCGG	Multiple matches in exons
AAGGACAGAGACCTGGGAGCTGG	AT%
ACCTCCCTTCGGGGCCCCTCTGG	AT%
GGGCGGGGGGCCCCCGAGGCCGG	AT%
AGGTCACAAAAGTGACCGTGGGG	Secondary structure or energy
CCGCGGCCCGGGTCCCCCTCCGG	Multiple matches in exons
GCCTCTGCAGGGAGTTGGGAGGG	AT%
GCCTTGGCTGTTTCCTCTGTGGG	Secondary structure or energy
GTGGCTCGTCATCGACCGCAAGG	AT%
CCTGCTATTTCCCTATCCTGAGG	Multiple matches in exons
GTTTGGGAGGCATTTGGCCCTGG	AT%
CTCACCCTGGCCCGGGAGGACGG	AT%
GCCCCGTGCGCTACGGCCTCCGG	AT%
AGGCTTCCACCAGAGTGCCAGGG	AT%
CCATTCCGCGGCAGCCAGCCCGG	Multiple matches in exons
GAGGGGCTCTGCACTCTAGGAGG	AT%
ACAGGTGGTTGGTTTTGAAGAGG	TTTT
GCGGCCAGCCCAGGTAAGCGCGG	AT%
CTGGGAGCGGACCATCCCCTGGG	AT%
GGTGTTGAAGTGGAGAGGAAGGG	Secondary structure or energy
CTGCACCGAGCCGCGGAGCCGGG	AT%
GGGTCCTTGTGGAAGATGTTGGG	Secondary structure or energy
CCTCACCGCATCGTGACAGGAGG	Multiple matches in exons
CCCTGGAAGAAGAGAGAGAGAGG	Multiple matches in exons
CCAGCAAGGTCTGGTTCGGCAGG	Multiple matches in exons
ACAGGACACCCAACCCCTGGAGG	AT%
GACGGTTGCCGCCCAGGTAGAGG	AT%
ACCCAGAAGGCAAGGGGGAGGGG	AT%
CAGCTACTCTCCCAGAGCCGCGG	AT%
CTCAGCAGAGGCGGGGAGAAGGG	AT%
CCCACGTGGCATAGAGTCTCCGG	Multiple matches in exons
GGAGTTGGTGACAAGAGCAGAGG	Secondary structure or energy
CCTTCACTGCCCCAAGTAAGAGG	Multiple matches in exons
CCACAGACTCCCTGCCAAGCAGG	Multiple matches in exons
GCAGTACTGGAGCGTGACGAGGG	AT%
GGCCTTCACTCCTGTGCCCTGGG	AT%
GGGCTGCAGCCGAGAGAACCTGG	AT%
GGAGGGACTGGGGAGTCTTGGGG	AT%
ATGGCTCGTGATCGACCGGAAGG	AT%
AAGCCCTTCCTGGGGGGCTCTGG	AT%
CCAGCAATGTCACCCGGAAGTGG	Multiple matches in exons
GGATCTGTGCTGGGGGGTTGGGG	AT%
GGCAGTGGGGCCATCTGGCCAGG	AT%
AGTCTGAGAGGTGCGCGCTCCGG	AT%
CACCCCCTCTTCTTCGCCCTGGG	AT%
AGTACCATGCCCTGGCGGGGAGG	AT%
GGGCCAGCTCACCAATCAGCAGG	AT%
GTCCAACAGGACCAGGGTGGAGG	AT%
ATGCTGGCAGACTGTGGGGCTGG	AT%
GGAGGCCGCAGGTGGCAGTGAGG	AT%
GCGCAGGAGGAAGGAGAGGATGG	AT%
AGAAGTTCGAGGGAGTCCTGGGG	Secondary structure or energy
CTGGGGCCTAGGTTTTTCCAGGG	TTTT
CTGCAAAATGAGATTTGGAAAGG	Secondary structure or energy
ACTGGCAGCATGGGGAAGGGAGG	AT%
GTAGACTGGCAGCATGGGGAAGG	AT%
CCATAGCATCCTCACTACAAGGG	Multiple matches in exons
GGTCACCCTGCCCCCTGCCGAGG	AT%
GGTCAGCTTCTCCAGCCATCCGG	AT%
AAACGGGGGCTATGCCCACCTGG	AT%
GCATAGGGGCACACCCTAGAAGG	AT%
GGCTGTGTGGGAACAGAAGAGGG	Secondary structure or energy
GTACCCAGAAGGCAAGGGGGAGG	AT%
CCCCAGCCACTAGAGCAGGGAGG	Multiple matches in exons
CGGGGGCGGGTCCGAGGGCGGGG	AT%
CATGGGGGTGCAGGTGCCTCAGG	AT%
CCAGCGTACCTCAAACAGGCTGG	Multiple matches in exons
CTGGGCGATGACACCTGGGGAGG	AT%
CAGTTTAGCCCAGAGGCATGGGG	Secondary structure or energy
CCCTGTCCCCAGGGACCTGGAGG	Multiple matches in exons
CATTGGGCCCAAGCGGGCTGTGG	AT%
CAAGTTTGGTGAGAGAGGAGAGG	Secondary structure or energy
CCATTCCTGCATTCTGCCATAGG	Multiple matches in exons
ACGAGCAGGACCGAGCCAGCTGG	AT%
GTACATGGGCCAGCCATAGGCGG	AT%
ATCCTCGGGCAGCTCCGACTTGG	AT%
GACAAGCCCTTTGCTTTCTCTGG	Secondary structure or energy
GCCTCATCCTCCTCAGAACCCGG	AT%
CTACACCTCCTGTCACGATGCGG	Secondary structure or energy
CGCGGCTCTGGGAGAGTAGCTGG	AT%
CCAGGAGAAGCCGTTGCTGAGGG	Multiple matches in exons
CCCCCAGGCGGATTCGATGGTGG	Multiple matches in exons
CTCATCGTGTGGCGTCTGGCCGG	AT%
CACCAGGGACAGCCTCTGAAGGG	AT%
CAGCTTGGAACTTGCCGATGGGG	Secondary structure or energy
GCTGGGTCAGGTAGAGGTCAAGG	AT%
GGTTGGCTGCAAAACAAACAAGG	Secondary structure or energy
GGCTGAACCAGTGGGGCTGACGG	AT%
CGAGCCGCGGAGCCGGGGAGCGG	AT%
GAATGGCCGGTGGCCCGTGGGGG	AT%
CAGGCTGGGGGGAGGGGGAGGGG	AT%
CACCTGCCCTCCAGCACCAGAGG	AT%
AGGCACCTGCACCCCCATGTGGG	AT%
GTGGGGTAGGGTGGACTGGCAGG	AT%
ACCTGGCCCGTCAGCCCCACTGG	AT%
CCTTACCAGAGGGGCAAGTCTGG	Multiple matches in exons
ACCCCAGAGTGAGTGGCAGGGGG	AT%
GCCTGCTGGCCAGCCCCCTGGGG	AT%
GGGAGTGGGGCTAGAGTGGAAGG	AT%
CATACCCACGGAGAAGCTGAGGG	Secondary structure or energy
CACTTCAGCTCCACAGACTCTGG	Secondary structure or energy
GACTCCTTCAGGGAGCTATAGGG	Secondary structure or energy
GTCAGGTCCACCTTGTTCAGAGG	Secondary structure or energy
ACTGGTTCAGCAGCCAGGTGAGG	AT%
CTCATGCGCACGTGTGGGAAAGG	AT%
CTCAAGTCAACTGGCAGCTCAGG	Secondary structure or energy
CCAGACTTGCCCCTCTGGTAAGG	Multiple matches in exons
GTGGAGGGGTGTGCTGGGGCAGG	AT%
GTGCCCTCCGACATCATTGCTGG	AT%
CGGCCCCCCTCCCGGCACACAGG	AT%
CAACAATGCCCAGGGGTTTGGGG	Secondary structure or energy
GCCGAGGAGCAGCTGCGCAGCGG	AT%
GTGCTGGAGGGCAGGTGGAGGGG	AT%
CGCTGGATACTCACGTGACGGGG	AT%
GCCTGGTGCTGCTTAGACAGCGG	AT%
GGCACGCCAGACTCGGGGCGTGG	AT%
CTACTGTGGCCCGCAGCTCCCGG	AT%
ACTGCTAAGAATGTCACCCTCGG	Secondary structure or energy
GAAAATTTTGCTGGCTTAGAGGG	TTTT
GCTCTGGGAGAGTAGCTGGAGGG	AT%
CCCCCAGGAGGCCTAGGGCATGG	Multiple matches in exons
CTGGCTCGCCTTCTACCCCCAGG	AT%
AGAAAGTGGTGATCAGTATCCGG	Secondary structure or energy
CACTTCGACACCCAGGATCACGG	Secondary structure or energy
GTGCACAACTCCTGAGGAAAGGG	Secondary structure or energy
CCACGAAGTCCAGGTCCAGATGG	Multiple matches in exons
GCACTGCACAATGGGCGCCTGGG	AT%
CCCAGCCTGGGGAAAGGGCTGGG	Multiple matches in exons
CTGGTCCGCTCTTCCAGGACAGG	AT%
AGGTGTCGGGGCAAGGGGTGGGG	AT%
GGTGACAGTGGGCCTTGAGGAGG	AT%
GGGGGAACATGGAAATGGGGGGG	AT%
GCGTGGTGAAGGATATGTCCAGG	Secondary structure or energy
ACACCCAGCCAGGGCCCAAGAGG	AT%
CCTTTCCCCAGGCTGGGGGGAGG	Multiple matches in exons
GCTGCAGCCTTGGGGGTGGGGGG	AT%
CGGCACCTGAAGCTGGGGATGGG	AT%
GCCCCAGGGTGAGTGGGGGCAGG	AT%
GGCTAGCTCTCCAATCAACAGGG	Secondary structure or energy
GTATCTCAGGTATTTCATGCTGG	Secondary structure or energy
CCTAGGCAGCCCAGAGAGGCTGG	Multiple matches in exons
GCAGAGGTTCCACCCGCATCAGG	AT%
GCCCCGGCCTGCCTGTGTGCCGG	AT%
GGCGTCCCTGGGTGCTGCCCTGG	AT%
AGCGGCAGGGCGGGGCCGGTGGG	AT%
ACCTTGTGGTAGTTGTGCCGCGG	Secondary structure or energy
CAACCCCTGGAGGCGGCTCTAGG	AT%
CAGACACCAGCACTGGGCCTGGG	AT%
GAGGAGCTGAGTGGGAAGGAGGG	AT%
GGGTGACCAGGAGTCTGTTGTGG	AT%
GAGCCCCCCAGGAAGGGCTTAGG	AT%
ACAGTGGGTGGAGAACAGAGTGG	Secondary structure or energy
CGGCCAGGGCGTGGCGATGCCGG	AT%
CAAGTTGGGGAGAAGTCTTGGGG	Secondary structure or energy
GCTCAGGTGCCCAATCCTGGAGG	AT%
ACCACGATCCCGGGCATGGCTGG	AT%
CACCTCCTGAAAGCAAGAAGGGG	Secondary structure or energy
CCGCCAGGTGCACCCTCCCCAGG	Multiple matches in exons
GCCTCATTAGACTGCCCCAGTGG	AT%
AGACAGGCAAAGTGGGTGCCAGG	AT%
CCAGCACCAGAGGCCAGGGAAGG	Multiple matches in exons
GCCCCCGCTCCCCGGCTCCGCGG	AT%
CGGGGCAAGGGGTGGGGATCGGG	AT%
CAGTCACATCTGGGTCTTTGTGG	Secondary structure or energy
GGGGCGCGGCATCGCCGGCGCGG	AT%
CCTTCACTCCATGCCACATCTGG	Multiple matches in exons
GCAGTTGAGTGGGGTGCCGTAGG	AT%
AGCGCCACCAGGCGCAACAACGG	AT%
GCCAGCCCGGCGTCCAACCCGGG	AT%
CCCAGCAGAAATGCTAAACTGGG	Multiple matches in exons
GAAGCCAGGGAGTGGCAGGTAGG	AT%
GTCTGGCAGTGTGCTGCAGGGGG	AT%
GGCTGGGAGAGCTTGTGCTGCGG	AT%
GGGGCCGCGCTTACCTGGGCTGG	AT%
CCTCAGTGTAGTCACTAGTGGGG	Multiple matches in exons
CCCAAGGATGGAAGGGGCTCTGG	Multiple matches in exons
CCTCCTCATCATCAAAGGCCCGG	Multiple matches in exons
CCACCATGCCTAGGCAGCTCTGG	Multiple matches in exons
ATCCTGGCTGGGTTCCTCTGGGG	AT%
AGGCGGGACACCAAAGAGACAGG	AT%
CACGCTCCGGCGCGCACACGCGG	AT%
GGCAACCTGGAAGTGGGGGTAGG	AT%
ACAAGACGAGGGCCTCCCTGTGG	AT%
ATGCAGGGAGCCAGTTTAGCCGG	Secondary structure or energy
CCCCTAAGCTCTTTTATACTTGG	Multiple matches in exons
GGCGTAGGCTCCTGCTTTCTGGG	AT%
CCTTGCCGATGACGTCGTTGCGG	Multiple matches in exons
CCTCTGCCCACTTGCTCTCCTGG	Multiple matches in exons
AGGGGAAACGCTCTATGAACAGG	Secondary structure or energy
GCTGGGGCTCCCTTACCAGAGGG	AT%
GCTTGGCTCAGGTTGTGTCCTGG	AT%
CGTATCCACCTAGAGGAGAGGGG	Secondary structure or energy
ACCGCCCCTAAGCCCTTCCTGGG	AT%
GGCTGTAGCGGGGCTGCGGCCGG	AT%
CCTGCCCGGCTCTCCGCGCAGGG	Multiple matches in exons
GGCACTGCACAATGGGCGCCTGG	AT%
CTGGTGGATATCATCGGGTAAGG	Secondary structure or energy
GATGGCCTCTGAGCTGCAGTTGG	AT%
CTTCCTAAAGTGTGCCACCAGGG	Secondary structure or energy
CCCACCCACCACGCAAGCAGAGG	Multiple matches in exons
GCTCCCAAGATGCCGTAGAAAGG	Secondary structure or energy
AGGGGGTGCATGTTGATATCGGG	Secondary structure or energy
GTGACCCAGCCTGGGTGGAGGGG	AT%
CCATGACATCAGCGGTGCCCTGG	Multiple matches in exons
CTGCCTTCCCTTCTGAGTTGTGG	Secondary structure or energy
GCACCACTCCCATCCTTCTCAGG	AT%
CCACTCACCCTGGGGCATAGGGG	Multiple matches in exons
CTGGTTCAGCAGCCAGGTGAGGG	AT%
ACTTCAACACCATCTCCAGGAGG	Secondary structure or energy
GTGGGGGCGGGTGCTCCAGGCGG	AT%
ACTCACTCTGACTCTGAGGAAGG	Secondary structure or energy
CCTACACTGAGCAGCATCCCGGG	Multiple matches in exons
GGGCCCCGTCGGGGCGGCCAGGG	AT%
GAGGAGCTTCCAAGGCTCGGAGG	AT%
GCTGAGGACCTGAGAGACTCCGG	AT%
CCCCGAAGGGAGGTGGGGTCAGG	Multiple matches in exons
GGCTGGGAGTGGGGCTAGAGTGG	AT%
GCCCCAGCACCGACACCCCATGG	AT%
ACCCGCGGGGGTCCAGTGACTGG	AT%
GGGGATGGTCCGCTCCCAGGGGG	AT%
CATTGTCAGGTATGGACATGTGG	Secondary structure or energy
CAGCTTCCAGTTGAGTCTGCAGG	Secondary structure or energy
GTGTTACAGGCTTGGGGCTGGGG	AT%
GGGTGCTGGTGTCCCAGGGCTGG	AT%
CCCGATGATATCCACCAGAGCGG	Multiple matches in exons
GCCCCTGCTGATTGGTGAGCTGG	AT%
GTTGGGAGGGTCCCTTTCCTGGG	AT%
ACTTACAGGGTCCCCAGGAAAGG	Secondary structure or energy
GTGTGTGTGTGTTGGGGGTGGGG	AT%
CCTCTCCCCAGGCCCAGTGCTGG	Multiple matches in exons
CGACGGCAGCTCGTCCGGCGTGG	AT%
CATCCGCTGGGGAGGCTGGTAGG	AT%
AGGTCCAAGGCACGGAGAGCTGG	AT%
GCTCAGATGGTGGAGCCCGCTGG	AT%
ACTTCAGCTCCACAGACTCTGGG	Secondary structure or energy
CCAACTCCTGCTTTGGCTCCAGG	Multiple matches in exons
CAGGGCTTGGGCTGGGTTGCGGG	AT%
GAGCACCAGTGAGTGTGGCCTGG	AT%
CCACGGTGCGGAGGACGCCACGG	Multiple matches in exons
GGTCATGGTGAGCCCCACCGAGG	AT%
CTTGGTGGCCTCACTCTTCATGG	Secondary structure or energy
GCACTGCGGGCCACCTTGGTGGG	AT%
CACCAACTCCATCATGAGTTTGG	Secondary structure or energy
GTCATCCTCACCCCCTGCTGGGG	AT%
CTCCATCCCGTCCTACATCCAGG	AT%
GTGAATACAGCCCCAGTGCCCGG	AT%
AGCTCTGGTTCGGACTGCTGTGG	AT%
GCCTCTAGCTAGAGAGGAATGGG	Secondary structure or energy
GGCAGATGGGGTGCATACCGAGG	AT%
CCATGACCTTCACGTTGCCGTGG	Multiple matches in exons
GACTGAGGCAGATGGAAGGAAGG	Secondary structure or energy
GGTGTCAGCGCAAACTGGTGAGG	AT%
CCTCGGGAAAGGGGCACTGTTGG	Multiple matches in exons
CTTTTGGCGCAAGCCTTTCTAGG	TTTT
CTTCCTCAATGGTGACCCCAGGG	Secondary structure or energy
ATCTAATGTTTAAAAGGTTAGGG	Secondary structure or energy
GCTACTCTGGGGTGGGGGTAGGG	AT%
GCCCCTAAGCCCTTCCTGGGGGG	AT%
GTTTTCTCTTCCCAGACAGGTGG	TTTT
AGTCTGGCAGTGTGCTGCAGGGG	AT%
ATCTGCGGACTTACAACCTGCGG	Secondary structure or energy
GCGCAGAACGCCTTGACCAGGGG	AT%
CTCACCATGGCAGGGGTGCCGGG	AT%
GGCCTGCCTGTGTGCCGGGAGGG	AT%
GAGATCGCCAAGACCTCCCTTGG	AT%
CTCCTGGCTGCTGAGGCCCGTGG	AT%
CGATGTTCTGGGAGATCATGAGG	Secondary structure or energy
GAGTCTGGAGGGCTTCTCTGAGG	AT%
CATTTAGAGCTCAGGATGGGAGG	Secondary structure or energy
CTGTGTTACAGGCTTGGGGCTGG	AT%
GTCTTTTCAATACAGCACAGAGG	TTTT
AGGCACCTGGTTGGGCCACAAGG	AT%
CCCGGAGACTCTATGCCACGTGG	Multiple matches in exons
CTGGCTGGAGCACAGGTCCAAGG	AT%
AGACAGGGAACCCTGCCCAAGGG	AT%
AGGAGGTCAGTGCTGGGTCCAGG	AT%
GGGGCACACAACAGGGCAGAGGG	AT%
AGTCCTTGGCTGGCAGCTCTTGG	AT%
CCAGCAGACGGTTGCCGCCCAGG	Multiple matches in exons
CTTTGGGGAGAGGCTCCCAGAGG	AT%
CGCTGTCAGCGCGGTTATAAGGG	Secondary structure or energy
GGGCTCATACTTTACAAGAGGGG	Secondary structure or energy
CCTTATGCTGCCATGGGGCCGGG	Multiple matches in exons
ATGAGGCATGTCTCGATAGAAGG	Secondary structure or energy
CCCTGCCCCCACTCACCCTGGGG	Multiple matches in exons
AAATGGGGGGGAGGGACTTGAGG	AT%
GCTGGGGCCTAGGTTTTTCCAGG	AT%
CTGGCGGTGGAGCGATTGACAGG	AT%
GAGCATTGCTGCTGAACAGGGGG	Secondary structure or energy
GTGTGTTGGGGGTGGGGCCGGGG	AT%
CCGGCACCTGAAGCTGGGGATGG	Multiple matches in exons
CACCGTTTTCCTAGTGGGCGAGG	AT%
GGGGAAGGTGTAAGGGCCACAGG	AT%
CCTCATCCTCCTCAGAACCCGGG	Multiple matches in exons
CCCCAGACCTACCCTGACAGAGG	Multiple matches in exons
CCTGGGTAAGGGACCCCCACGGG	Multiple matches in exons
CCTCCAGGTCCCTGGGGACAGGG	Multiple matches in exons
GCGGCCGTTGTTGCGCCTGGTGG	AT%
ATAAATATTTTAAGGGTCTGGGG	TTTT
CAATGTCGTCCCTTGGGCCTGGG	AT%
CAGAGACTTGGTGAGCTGCCTGG	AT%
CAAAGCTACTGGGCCCTGAGTGG	AT%
GTGCTTGTGCACACTAGGGCAGG	AT%
CGAGAAGGCTGGACTCGAGGTGG	AT%
GGCGGCGGCAGCGTGCTCCGCGG	AT%
GTTGTGGTTGTTTGGATATACGG	Secondary structure or energy
ACACCCAGGTAGGGGTAGGTGGG	AT%
CTGCTGGGTGTGATGGAGCTCGG	AT%
CAACTCTCCTTGTGCCGGCTGGG	AT%
ACTCCTGTGCCCTGGGGCTCTGG	AT%
AGGCGCAGGACCCAGGGCTCTGG	AT%
CCATGCGCAACAGCGCGGGCGGG	Multiple matches in exons
GACTACAAGTATATATAACAGGG	Secondary structure or energy
AGACAGCCTGGAGAAGGCCAGGG	AT%
AACGCTGACTGATGCAGGCCTGG	AT%
GGCTGTCCCAGGTTAGCCTGAGG	AT%
CATGGTGAGGGGAGACCCCGAGG	AT%
CCCAGGAGGGACAGCTTGGTAGG	Multiple matches in exons
GCAGCCTGGCACCTACTTGATGG	AT%
CGTGGGAGTTTCTTCCCGCCTGG	AT%
GGAGCGGCCCGGGCCCCGTCGGG	AT%
CAGAAAACGCTGACTGATGCAGG	Too close to reverse primer
AGTTAAGTGTCGCATTAGCACGG	Secondary structure or energy
GTGAGAATATGTGGGAGTGAGGG	Secondary structure or energy
CTCTGTCAGGGTAGGTCTGGGGG	AT%
GACGAAGGGGACCATGTACCGGG	AT%
GGAGCCCCAGCCACTAGAGCAGG	AT%
ATGCCGGTGGGACAGGAAGTAGG	AT%
CACGATGATGGAGTTGGCAGAGG	Secondary structure or energy
AGAGGCGCGTGAGGCGCGGTAGG	AT%
ACGGGCCTGAAAAGAAACCCAGG	Secondary structure or energy
CTATGAATCTAATGTTTAAAAGG	Secondary structure or energy
CGCGGCCCGGGTCCCCCTCCGGG	AT%
GGGCATCTATAACTTTCACTTGG	Secondary structure or energy
AGGGATGCCCCTTCTTTGCCTGG	AT%
GCACAGTACCACGGACACAGGGG	AT%
AAAGGCCCGGGTTGGACGCCGGG	AT%
GCATCCAGTGTTGAGGGCCCAGG	AT%
GGTCCTACCAGCCTCCCCAGCGG	AT%
CCTTCGTCGCCGGCTCCCTCCGG	Multiple matches in exons
AACAGGGCAGAGGGAGCTGCTGG	AT%
CCTCTTCCTCCTCCATATGGAGG	Multiple matches in exons
GTGGGGGAAGGAGGCAGTGCTGG	AT%
GGCGGCTCTGAGGAGCCCGGAGG	AT%
CCCACTGGTTCAGCCCTATGAGG	Multiple matches in exons
ACAGGGAAGGTAGGAGAGGAAGG	Secondary structure or energy
GGTGTCCATCCCTCTGAACAAGG	Secondary structure or energy
CTGGGCGGAGGCCGGGCCAGGGG	AT%
AAGCAGGCAGGACAAAGGCCAGG	AT%
CTTCTTCCCCCAGGAGGCCTAGG	AT%
GGGGAGGCTGGTAGGACCTGTGG	AT%
CGCCCCTCCCCCTTGCCTTCTGG	AT%
GGCCTGCTCACCTCTGGTCAGGG	AT%
CACACTGAGGACCTCTTCCCAGG	AT%
AGTCAGTCACCTACCTGGGGAGG	AT%
GCTCATGGACCTGACCCCCACGG	AT%
CCGGGTCATCAGCCACTACGCGG	Multiple matches in exons
GCACGGGGCTGCCAAAAGTGAGG	AT%
GGCTATATTCTTGGCAGGTTAGG	Secondary structure or energy
ACCTTCCCACATGGGGGTGCAGG	AT%
GGCTTGCCAGAGCCACATACAGG	AT%
CGCTCCCCGCAGCCCTAGCCCGG	AT%
CCTGTGTCCTTCACAGCTTCAGG	Multiple matches in exons
GTGTCCACCTACCAGGGGACAGG	AT%
CCGGGTAGACTGGCAGCATGGGG	Multiple matches in exons
GCGGTTTTCTTATCTGTCAGTGG	TTTT
CCATGGTGGAAGACCGTATCTGG	Multiple matches in exons
CCTCTTACTGCAGCCATGCAGGG	Multiple matches in exons
GCTCGGCACGGCCCCCCTCCCGG	AT%
GGTGGCTGGATTTCCAGCCCTGG	AT%
GAAGTCTGGGGAGCTGTGGCTGG	AT%
CCTGACCCCACCTCCCTTCGGGG	Multiple matches in exons
GTGGCAGCGGCGTCCCGGGCCGG	AT%
GCCCGGGTTGGACGCCGGGCTGG	AT%
AGGTGGGCTGGAGGTGGGGGCGG	AT%
CGCCCAGGCGGTTGCGGTCGAGG	AT%
CGTGATCCTGGGTGTCGAAGTGG	AT%
CTGGGGGAACATGGAAATGGGGG	Secondary structure or energy
ATGGAGAGGCTGGGCCAAGCAGG	AT%
GGGCGTAGGCTCCTGCTTTCTGG	AT%
AATAAATATTTTAAGGGTCTGGG	TTTT
AGGAGTGGCCTACCACAATCAGG	Secondary structure or energy
GGTGCGGTTGGTAGGAGACCAGG	AT%
AGTCTCCAAACCACCCAGGTAGG	Secondary structure or energy
GAGGTGTCGGGGCAAGGGGTGGG	AT%
GAGTGGGCCTCAGTGTGGAGAGG	AT%
CGGGCTGGCTGCCGCGGAATGGG	AT%
AACGGTCATAATCCAGGACCTGG	Secondary structure or energy
CATCGCCTGTCAGGTCAGTCAGG	AT%
ACAAAAAGGTCATGGGAGAATGG	Secondary structure or energy
GTGTCCATTAACCTGAGAAGTGG	Secondary structure or energy
CCGTGGCATTGGGCCCAAGCGGG	Multiple matches in exons
GTGTGTGTGTGTGTGTGTTGGGG	Off-target score
CCCCCAGGGGTGGGAACTGGTGG	Multiple matches in exons
ACACTCACTGGTGCTCAATCTGG	Secondary structure or energy
CTCACAGGACACCCAACCCCTGG	AT%
CAGTATGGCTGCAGCCTTGGGGG	AT%
GCGCCTCACGCGCCTCTACCTGG	AT%
GCCATGGGGTGTCGGTGCTGGGG	AT%
CTCCCCAGATCTACCTGTCCTGG	AT%
GTTGCATCCGCTGGGGAGGCTGG	AT%
GAGGGGTGTGCTGGGGCAGGTGG	AT%
CACCGTGGTGGCCGATGAGGCGG	AT%
CTTGGGCTCCAAGCTGCTTGAGG	AT%
CTGGCAGCTCAGGGGCTTTCAGG	AT%
GGCTTTCAGCTGGTGCCACTGGG	AT%
GCGGGTGCCAGGGTGGAGTCTGG	AT%
CTGGGGAATTGTGGGGGTGGGGG	AT%
CGAGCCTTGGAAGCTCCTCCAGG	AT%
GCGCAGAGAGACTTCACCAGTGG	AT%
CTTGACTTTTCATTGTGGCTTGG	TTTT
GTGACCCCAGGGGCGAATCGGGG	AT%
CCTTGGGGGACAGTGTTCCCCGG	Multiple matches in exons
GGCTGTCAGCTTCCAGCCTGTGG	AT%
ATTGGTTCCAAAGAAGAGACTGG	Secondary structure or energy
CCCCGGGCCAGGCTGTAGCGGGG	Multiple matches in exons
ACACCCCATGGCTCCAAGCTGGG	AT%
CTTGATGTCATTCTCACGGATGG	Secondary structure or energy
GCCCCCAGACTCAGGCTCTGAGG	AT%
GGGTCCAGCTCTCCGTGCCTTGG	AT%
ACGCCCTGGCCGCCCCGACGGGG	AT%
CCAGCAGCCAGAGGCAGACACGG	Multiple matches in exons
ATCTGCTCCACACTCTGGCTTGG	Secondary structure or energy
AGGAGGGTCAGGCCACCAGCTGG	AT%
GGAGACAAGGGCACAAGGGTGGG	AT%
CCCAGCCGGCACCTGAAGCTGGG	Multiple matches in exons
GTTCTTGAGGTCGAGGTACTTGG	Secondary structure or energy
GGGCGAATCGGGGTCGTGCAGGG	AT%
CTGCGGCGGGCCGGAGGTAAGGG	AT%
GTTGCAGACGACCATTCCTGTGG	Secondary structure or energy
CCCTCCAGAGGCCCGCCAGGTGG	Multiple matches in exons
CCCAGTTTAGCATTTCTGCTGGG	Multiple matches in exons
AAGGCCGAGGCGTTTGGCCACGG	AT%
GGCAGCTCTGGGAGGCTCAGCGG	AT%
GGAGGGGGCCATGGCGCCCAGGG	AT%
GACTGTCGCGCGGGCCGCGCCGG	AT%
GGCATCCAGCCCCAGAAAGCAGG	AT%
CCTCAAGACGAGGGACAAGAGGG	Multiple matches in exons
AGGGCAAGGGCTCCACGGAGTGG	AT%
CCAGCACTCACTTCATCTGCAGG	Multiple matches in exons
CTTGCGCATGTTGTTGGCAGTGG	Secondary structure or energy
CAGCTGGATGACACAGAGGCTGG	AT%
CGCGCGCCGCCAACTCTGCCGGG	AT%
GCCTCTCCTTGCAGCCATCTTGG	AT%
CACAGGAAGGACCTTCCCCAGGG	AT%
AGGCCTTCCATTTAGAGCTCAGG	Secondary structure or energy
AGGGATTCCTCCAGGTCCCTGGG	AT%
GTTGTCAACAAAAGTGACTGAGG	Secondary structure or energy
CTGCATAGTTACCTGAGAGATGG	Secondary structure or energy
CACAGTGCAGGAGGTGAGGTGGG	AT%
CAGCTCCTCGGGGGAGCTCATGG	AT%
ACTATTCCTAGTAGTCTGAGGGG	Secondary structure or energy
CTGAGAGGTAGCGAGGACAAAGG	Secondary structure or energy
GGCGGGGCCGGTGGGGCGGGCGG	AT%
AGCCCTTTCCCCAGGCTGGGGGG	AT%
AACCTTTCTCCTTTAGGCTCAGG	Secondary structure or energy
CCTGGGGAAGGTCCTTCCTGTGG	Multiple matches in exons
GCAGAGGGTAGGTGAGGGTGGGG	AT%
CGGGTCATCAGCCACTACGCGGG	AT%
GACTCACCATTCACCTGCTGAGG	Secondary structure or energy
CTCTTGGATGGGCAGCTTCTTGG	Secondary structure or energy
GGTGGTGGCAGCGGCGTCCCGGG	AT%
GGAAGCCCAGCAGCTCTTCCTGG	AT%
ACTTCACAGTGCAGGAGGTGAGG	Secondary structure or energy
CTTCCAGGACAGGTAGATCTGGG	Secondary structure or energy
CTGCAGGCAACCTGGAAGTGGGG	AT%
GGCTCTGGGAGAGTAGCTGGAGG	AT%
AGGTGCCAGACCCTGACCACTGG	AT%
AGCTCACGGTTGGGAGAGGCTGG	AT%
GCCTTGAGCTCTGGCTGGGAAGG	AT%
CTTGCTGCAGAGGGTAGGTGAGG	AT%
GCGGCCGCAGCGGCAGGGCGGGG	AT%
CAGGGTCTCCGTGGGATTTGGGG	AT%
CAGCCTTGGACCCTTGATCCTGG	AT%
AGTTGGGAGGGTCCCTTTCCTGG	AT%
AGTCTGCAGGGTAAGAGGCCGGG	AT%
CTTCACTTCAGAGTGGGGCAGGG	Secondary structure or energy
ACCTGGCCGCATCATCCACGTGG	AT%
CCCGGGAGCCCCCCGGGTGGCGG	Multiple matches in exons
ACTGGCACCTTGACACCCCAAGG	AT%
GGCCTCAGAGCCTGAGTCTGGGG	AT%
CAAAGAAGAGACTGGCTTCACGG	Too close to reverse primer
CACGCCGGACGAGCTGCCGTCGG	AT%
CAACCCAGAGCAGGAGGAAGAGG	AT%
CGGGTCCTTGTGGAAGATGTTGG	Secondary structure or energy
CTGCTTTCTGCCGCGGCTCTGGG	AT%
ATTCTCCAGCAGCTGGATGGAGG	Secondary structure or energy
AGGCATGGTGGGGTGATAGAAGG	Secondary structure or energy
CTGCAGAGGGTAGGTGAGGGTGG	AT%
GCCCCCCCACCCCTCCACCCAGG	AT%
CACCCCTGGCTGCAGAGTCAGGG	AT%
AGCAGGTAGATCTTGACAAAGGG	Secondary structure or energy
CTCATCCTCCTCAGAACCCGGGG	AT%
CCTGTTGTGTGCCCCACTGCAGG	Multiple matches in exons
GGGCATCGGAGCCTGGCGCTCGG	AT%
CAGTCTCCTAGGGTAGGCCTAGG	AT%
GCCCGGAGGCCGTAGCGCACGGG	AT%
CTGGGCCCTGAGTGGTTGTTAGG	AT%
CAACAGTGCCCCTTTCCCGAGGG	AT%
GGCTGGCCCCGTGGCCTGTGGGG	AT%
GGCTGGGGGGAGGGGGAGGGGGG	AT%
CGCCTCCGGGTCCCGGTACATGG	AT%
GCCTCACTCTTCATGGGCTTTGG	Secondary structure or energy
CACAGCTCTCAGCTCTGGTTCGG	Secondary structure or energy
CGGGGGCTATGCCCACCTGGCGG	AT%
GTCTCTCTCAGGCACGTGAAGGG	Secondary structure or energy
GAAGTGGAGAGGAAGGGGAGAGG	AT%
GCATCGAGGAGATCGTGAGGCGG	AT%
GGGTGGGGCCGGGGGAGTTCTGG	AT%
CCATACTGTGTTACAGGCTTGGG	Multiple matches in exons
GGGCAGGGCCCATGGAATTATGG	AT%
CCGCCCTCGGACCCGCCCCCGGG	Multiple matches in exons
ATTCTCACGGATGGCACTGGGGG	Secondary structure or energy
CCTTGACTTCACAGTGCAGGAGG	Multiple matches in exons
CCTTCCTGTGGAGGTAAGCTGGG	Multiple matches in exons
GCCGGGGGAGTTCTGGCCAGAGG	AT%
CAGGGAGTCCTCAGGAGGCCTGG	AT%
CTTTCTACAGCCCTCTATGCAGG	Secondary structure or energy
ACTGCTGGTCCCAGGGCGATAGG	AT%
AGCGGCAATGGGCGGTGTCGGGG	AT%
AGGGTACTTAGTACAGATTAAGG	Secondary structure or energy
CATCAGTCAGCGTTTTCTGCAGG	TTTT
AGGGAAGGCAGGGAGAGTGAAGG	AT%
GCTGTGTGAGGGTGACCAGTTGG	AT%
AGTGACCCAGCCTGGGTGGAGGG	AT%
CTCTGTGGCAGGCAGCTCCAGGG	AT%
GCCCGGGGGCGCGGCATCGCCGG	AT%
GTCAGGTGAGGGAAGACAGCCGG	AT%
CCCCCGAGCCCAGTTCCCAGTGG	Multiple matches in exons
GAAGCTCTACGGGGTCTTGTCGG	Secondary structure or energy
GGGGAGAACAGCTATGTGGGGGG	AT%
ATCTTGGGGAGCGGAGGGGGAGG	AT%
CTGCAGTGGGGCACACAACAGGG	AT%
CACATCTATGGTAGCAGTTGGGG	Secondary structure or energy
GTCGATGACGAGCCACCGGTCGG	AT%
GGGTTACACCCAGCTGGGCAAGG	AT%
GGCCATGCCCTAGGCCTCCTGGG	AT%
CAGCCGCAATGACCCCATTGGGG	AT%
GCAGCCAGGGGTGAGGTCACAGG	AT%
CCATGCACATTGATCACGACCGG	Multiple matches in exons
GACAAGCTCTGCTATTCCCAGGG	Secondary structure or energy
GAGGGGGTGCATGTTGATATCGG	Secondary structure or energy
CTAGAGCCGCCTCCAGGGGTTGG	AT%
CCCCAGCTTCAGGTGCCGGCTGG	Multiple matches in exons
CCCTAGGCAAGGAGGCCACAGGG	Multiple matches in exons
ACTTCCTGCGGCGCTTTCCGCGG	AT%
GAGCGTGAGGAGAGCCTGGCCGG	AT%
CCAGGAGTCTGTTGTGGGGTGGG	Multiple matches in exons
CCCGGGGGCGGGTCCGAGGGCGG	Multiple matches in exons
CTCCCTGCCCCCACTCACCCTGG	AT%
ACTTGAGGGTCGGGTACTGGGGG	AT%
GGGCAGGCTGCTTCAGAATGAGG	AT%
ACAGAGCCCTGGCACTCTGGTGG	AT%
GCAGTGCCAGCTCTCCCCGGGGG	AT%
AAGACTCAGGCCCAGATGCCAGG	AT%
CTCTGTGGGGTAGGGTGGACTGG	AT%
CTGATGACCCGGGAGCCCCCCGG	AT%
ACCAGTGGGGCTGACGGGCCAGG	AT%
CCTGCCACAGGGTCAAGAGAGGG	Multiple matches in exons
CGGCCATTCCCGGCTCCAGCGGG	AT%
GACTGATGCAGGCCTGGTCTGGG	AT%
CCTGGGGGCCCCAGCTGAGCTGG	Multiple matches in exons
GGGTGGCTTTGGTAACAGGGAGG	AT%
CCGTCGGTGTTGCGAGCCGCGGG	Multiple matches in exons
GGAGGAGTTTAAGCCCCGCCTGG	AT%
CAGTGTCCCTGAGTGTCCTCTGG	AT%
AGTTGCTACTGGGGAATTGTGGG	Secondary structure or energy
CCCCGGCCTGCCTGTGTGCCGGG	Multiple matches in exons
GGCCACTCTCCCCCCAGATCTGG	AT%
CAGACCCCTATGTGAAGGTGTGG	Secondary structure or energy
CCTGGCTGCTGAGGCCCGTGGGG	Multiple matches in exons
AGTTCTAGTCTCAGCAGAGGCGG	Secondary structure or energy
CTCACTCCCTGCACAACTACTGG	Secondary structure or energy
AGGGGCACCAGGCAAAGAAGGGG	AT%
GCGAATCTTCATGGAGAATGTGG	Secondary structure or energy
GCGCCACCAGTTCCCACCCCTGG	AT%
GTGCATCTGGGAGGGACTTGCGG	AT%
CCTGAGAGATGGCCAGGATCAGG	Multiple matches in exons
GGGCATCGCAGAGTCCACGCCGG	AT%
CCCGAGGGCTCAGCCAGGGAGGG	Multiple matches in exons
ACCACCCTCACTGCCACCTGCGG	AT%
GGCCCTGGGTCTGTGTGAATTGG	AT%
ATCTGGCTGAGCATGCGTGGGGG	AT%
AGTGGTGTGCTGCTGCTGACAGG	AT%
GTAGGCCACTCCTTGGGAGCAGG	AT%
AGCTGGCCAAGCGCAGTGAGAGG	AT%
ACAGAAGTAGACATAGACTGGGG	Secondary structure or energy
GCCACTCCCTGCTCTGTCCAGGG	AT%
CCCAGCCGGGACTGTCGCGCGGG	Multiple matches in exons
GCCCAGCTCCCTGGGAGGACAGG	AT%
AGCGTGCTCCGCGGGCGGCCCGG	AT%
GCTTGCGTGGTGGGTGGGAGGGG	AT%
GTGCCGGCTGGGGTACTTACTGG	AT%
CACTGCGGGCCACCTTGGTGGGG	AT%
AGCCCTTCAGAGGCTGTCCCTGG	AT%
CAAATCCCACGGAGACCCTGAGG	AT%
AGTGGGGTGCCGTAGGTCGGGGG	AT%
GGAAGCTCACAAGATGGTTCGGG	Secondary structure or energy
GGTTGGCTACTCTGGAAGAAGGG	Secondary structure or energy
CATGGAGCTGAGTAAGGCTTGGG	Secondary structure or energy
GTACGTGCTCTACGTGCGCCTGG	AT%
